CATATAATTCTCGACTTAGCTGCT -> ATATAATTCTCGACTTAGCTGCTT
GACTTAGCTGCTTATTGGGTGCAA -> ACTTAGCTGCTTATTGGGTGCAAG
CAACGTAAAACTCCCCCTGCTTCG -> AACGTAAAACTCCCCCTGCTTCGC
GTCTATTATTTTTTGCTCTAGGAG -> TCTATTATTTTTTGCTCTAGGAGC
GTCGAGCCAAGCTGCGAGCCACTC -> TCGAGCCAAGCTGCGAGCCACTCC
AACGACTTGAACGCGCATTGCTTC -> ACGACTTGAACGCGCATTGCTTCC
TAGTAGGTATAACTTAACGACTTG -> AGTAGGTATAACTTAACGACTTGA
GTCACGAGCTCCCATCTGGCTGCA -> TCACGAGCTCCCATCTGGCTGCAG
GAGTTCGCGTCAGAGGTTAGGTTG -> AGTTCGCGTCAGAGGTTAGGTTGC
CGTGGGCTACGGCCAACGTAAAAC -> GTGGGCTACGGCCAACGTAAAACT
GAGGTACATAGCCCCCTCCTTCCC -> AGGTACATAGCCCCCTCCTTCCCG
CACGCCAAGCCCTTAGTAAAACAA -> ACGCCAAGCCCTTAGTAAAACAAA
TAGTAGTAGGTATAACTTAACGAC -> AGTAGTAGGTATAACTTAACGACT
GTAATTACGACGTCAAAACGTACC -> TAATTACGACGTCAAAACGTACCA
ACTTGTGCTATAGTAACACCTGGC -> CTTGTGCTATAGTAACACCTGGCA
GGTAGGCATGGGTTTGGGGTGGAA -> GTAGGCATGGGTTTGGGGTGGAAT
TAGTATTCCGACTTCGCTAGACTT -> AGTATTCCGACTTCGCTAGACTTA
TACGGTGCTATCCCCCTAACGTAA -> ACGGTGCTATCCCCCTAACGTAAT
TTCGCACGACAGGGAACTTCAGTC -> TCGCACGACAGGGAACTTCAGTCC
AATTACGACGTCAAAACGTACCAC -> ATTACGACGTCAAAACGTACCACG
GTAACACCTGGCACGCCAGACACA -> TAACACCTGGCACGCCAGACACAA
TTGCTGAATTAACAGGTCGTATCC -> TGCTGAATTAACAGGTCGTATCCC
AGTCCGGGAGTTCGCGTCAGAGGT -> GTCCGGGAGTTCGCGTCAGAGGTT
CATACGATTCGCCGTGCCTATACC -> ATACGATTCGCCGTGCCTATACCA
GCGGTCCCAAGGTCGAGAGCAATA -> CGGTCCCAAGGTCGAGAGCAATAA
ATCGGTTGCGTAAACCGATGTGGC -> TCGGTTGCGTAAACCGATGTGGCC
AACTACGGTGCTATCCCCCTAACG -> ACTACGGTGCTATCCCCCTAACGT
ATATAGGGCCCATATAATTCTCGA -> TATAGGGCCCATATAATTCTCGAC
AGACACAAGATAGAGTTCATATAG -> GACACAAGATAGAGTTCATATAGG
GCTCCTGCAGACGCTTCTAGTAAA -> CTCCTGCAGACGCTTCTAGTAAAC
CTCTCAGTTAAACGGCTTCGCAGA -> TCTCAGTTAAACGGCTTCGCAGAA
TTTGCCGAGGTAGAGAAATTCTCG -> TTGCCGAGGTAGAGAAATTCTCGC
AGATAGAGTTCATATAGGGCCCAT -> GATAGAGTTCATATAGGGCCCATA
AGTCGAGGTAGTTACGATAGTGGC -> GTCGAGGTAGTTACGATAGTGGCC
CCTGCTATTTGAACTCTCGGGGAG -> CTGCTATTTGAACTCTCGGGGAGA
GTCGCCGGGTAGGCATGGGTTTGG -> TCGCCGGGTAGGCATGGGTTTGGG
GTCAACATGGTCTACAAACTTTCC -> TCAACATGGTCTACAAACTTTCCG
CTCGCCCACTACGAAAGCCTACAC -> TCGCCCACTACGAAAGCCTACACT
GCGTCAGAGGTTAGGTTGCGAATT -> CGTCAGAGGTTAGGTTGCGAATTG
TGCCATCTGGGCATTAAGCAGTGA -> GCCATCTGGGCATTAAGCAGTGAA
CATATCGTACGATGCTACAATCTG -> ATATCGTACGATGCTACAATCTGC
AGGAAAAATACGACTTGTGCTATA -> GGAAAAATACGACTTGTGCTATAG
GCTATTTGAACTCTCGGGGAGAAT -> CTATTTGAACTCTCGGGGAGAATT
AAGATAGAGTTCATATAGGGCCCA -> AGATAGAGTTCATATAGGGCCCAT
TTTTTAACACGTAGTCAACATGGT -> TTTTAACACGTAGTCAACATGGTC
ACATGGTCTACAAACTTTCCGTAT -> CATGGTCTACAAACTTTCCGTATT
TTCCGTATTCCATCAGCGAGCGTG -> TCCGTATTCCATCAGCGAGCGTGC
ACTCCCCCTGCTTCGCTTCAGATC -> CTCCCCCTGCTTCGCTTCAGATCA
GTTACCCAGGTGAGAGCATAGTGA -> TTACCCAGGTGAGAGCATAGTGAA
GCGATTCGTTTTTAACACGTAGTC -> CGATTCGTTTTTAACACGTAGTCA
GATCTTAAGTAACATTGAACCACG -> ATCTTAAGTAACATTGAACCACGC
GGACATCTACGGTGGTCCGGATTA -> GACATCTACGGTGGTCCGGATTAC
GTCAAAACGTACCACGGATAGGCT -> TCAAAACGTACCACGGATAGGCTC
GAGAGCAATAACAGCATTTGTCGG -> AGAGCAATAACAGCATTTGTCGGG
TCAGTCGAGGTAGTTACGATAGTG -> CAGTCGAGGTAGTTACGATAGTGG
TGAGGGAAAGCTCCACTGAGCGCT -> GAGGGAAAGCTCCACTGAGCGCTC
CGACGTAGGGAACGCGATTCGTTT -> GACGTAGGGAACGCGATTCGTTTT
ACAAGATAGAGTTCATATAGGGCC -> CAAGATAGAGTTCATATAGGGCCC
CCTGAATGCATTATGGGGTACGTG -> CTGAATGCATTATGGGGTACGTGA
AATACGCGTCGCAGCTCAGTCGCC -> ATACGCGTCGCAGCTCAGTCGCCG
CCAAGGTACACACGTATCTCCGCC -> CAAGGTACACACGTATCTCCGCCG
ATTGCTTCCGCGCGAATCGGGTCA -> TTGCTTCCGCGCGAATCGGGTCAG
GGGAATTGAGTTTGTGGCGCGTAG -> GGAATTGAGTTTGTGGCGCGTAGT
CCTCCTTCCCGTGGTTGCTCCCGT -> CTCCTTCCCGTGGTTGCTCCCGTC
GGTAGAGAAATTCTCGCCCACTAC -> GTAGAGAAATTCTCGCCCACTACG
AAGCTCCACTGAGCGCTCTAGCGC -> AGCTCCACTGAGCGCTCTAGCGCA
AAATATCCGCATCGCAGGAACCCC -> AATATCCGCATCGCAGGAACCCCT
AGTGGCCGTAAGTAACCGTCGCAG -> GTGGCCGTAAGTAACCGTCGCAGG
ATTTTTTGCTCTAGGAGCATCTGA -> TTTTTTGCTCTAGGAGCATCTGAC
ATAGAAATGGGTCTATTATTTTTT -> TAGAAATGGGTCTATTATTTTTTG
ATTGAACCACGCTTGTGCTAACTG -> TTGAACCACGCTTGTGCTAACTGC
TTGTACTAATTCGGCTACTAAAGA -> TGTACTAATTCGGCTACTAAAGAC
CACTGACCCGTACGTGGTATCTCA -> ACTGACCCGTACGTGGTATCTCAT
AGTCCAGAGTAGGTTCAGAGCAGT -> GTCCAGAGTAGGTTCAGAGCAGTA
AAGGCCTCTCCCTCATCGGTTGCG -> AGGCCTCTCCCTCATCGGTTGCGT
CTGCGCCCGGAGGCATAACTTAGT -> TGCGCCCGGAGGCATAACTTAGTA
GAGGTAGAGAAATTCTCGCCCACT -> AGGTAGAGAAATTCTCGCCCACTA
TTCTCGCCCACTACGAAAGCCTAC -> TCTCGCCCACTACGAAAGCCTACA
TATAATCAAAGGTCGGCGGTCCCA -> ATAATCAAAGGTCGGCGGTCCCAA
TTGCGAATTGACGCTCCCTTAAGG -> TGCGAATTGACGCTCCCTTAAGGC
TTTGCCTGCCCGGAATGCAATACG -> TTGCCTGCCCGGAATGCAATACGC
GGCTGAGAAGGACACTAGACGATG -> GCTGAGAAGGACACTAGACGATGG
TGAACCACGCTTGTGCTAACTGCA -> GAACCACGCTTGTGCTAACTGCAC
TCGCCGGAGGCGTCTGAGAGTTGT -> CGCCGGAGGCGTCTGAGAGTTGTT
GGTTGCGAATTGACGCTCCCTTAA -> GTTGCGAATTGACGCTCCCTTAAG
AACGCGCATTGCTTCCGCGCGAAT -> ACGCGCATTGCTTCCGCGCGAATC
GGCATAACTTAGTATTCCGACTTC -> GCATAACTTAGTATTCCGACTTCG
GGCGTGGGAGATCCATCACTTCTA -> GCGTGGGAGATCCATCACTTCTAC
CCCTACCGGCCATCACTATTGCCG -> CCTACCGGCCATCACTATTGCCGC
ACGCCAAGCCCTTAGTAAAACAAA -> CGCCAAGCCCTTAGTAAAACAAAC
GCTAACTGCACGGTGAGGGAAAGC -> CTAACTGCACGGTGAGGGAAAGCT
CATCGGATCCAGTCTGCTAACTAC -> ATCGGATCCAGTCTGCTAACTACG
TCCCCCTAACGTAATCATGGCTGA -> CCCCCTAACGTAATCATGGCTGAG
CGTACCACGGATAGGCTCCCGGAT -> GTACCACGGATAGGCTCCCGGATT
TAGTCCAGAGTAGGTTCAGAGCAG -> AGTCCAGAGTAGGTTCAGAGCAGT
GGAGGCGTCTGAGAGTTGTTAGTA -> GAGGCGTCTGAGAGTTGTTAGTAT
GAGTAAGCAATCATTCAGAAATCG -> AGTAAGCAATCATTCAGAAATCGC
CATTCAGAAATCGCCGGAGGCGTC -> ATTCAGAAATCGCCGGAGGCGTCT
CAGATCTACCCAGTTAAGAGCTCC -> AGATCTACCCAGTTAAGAGCTCCT
ACACGCTACAGGACATCTACGGTG -> CACGCTACAGGACATCTACGGTGG
AACACGTAGTCAACATGGTCTACA -> ACACGTAGTCAACATGGTCTACAA
GACCGTAAACCTGTCACCTGGCCC -> ACCGTAAACCTGTCACCTGGCCCG
TGTCGGGGAACCCTTCTGGTGATC -> GTCGGGGAACCCTTCTGGTGATCT
AGAGAAAGTCACACTGACCCGTAC -> GAGAAAGTCACACTGACCCGTACG
TAACTACGGTGCTATCCCCCTAAC -> AACTACGGTGCTATCCCCCTAACG
ACGATGGACGGTTGCCGAGTAAGC -> CGATGGACGGTTGCCGAGTAAGCA
AGGTATAACTTAACGACTTGAACG -> GGTATAACTTAACGACTTGAACGC
ATGGCCTCACGCCAAGCCCTTAGT -> TGGCCTCACGCCAAGCCCTTAGTA
CACCTGGCCCGGGTGTCTGGCAGA -> ACCTGGCCCGGGTGTCTGGCAGAT
TTTCGTTGGATGCTAGAGAGAAAG -> TTCGTTGGATGCTAGAGAGAAAGT
GGCCTCACGCCAAGCCCTTAGTAA -> GCCTCACGCCAAGCCCTTAGTAAA
TCCGCGCGAATCGGGTCAGGTCAC -> CCGCGCGAATCGGGTCAGGTCACG
ATCATTCAGAAATCGCCGGAGGCG -> TCATTCAGAAATCGCCGGAGGCGT
CGCCGTGCCTATACCATCCCATCA -> GCCGTGCCTATACCATCCCATCAG
GAATTGTACTAGCCTACAAGTCAT -> AATTGTACTAGCCTACAAGTCATC
CTTCGCTAGACTTACGTAACTAGC -> TTCGCTAGACTTACGTAACTAGCT
AGGCGTCTGAGAGTTGTTAGTATC -> GGCGTCTGAGAGTTGTTAGTATCT
CCCATCAGATCGTCCCACGGGTGG -> CCATCAGATCGTCCCACGGGTGGC
TCTACGGTCCCGTATAATCAAAGG -> CTACGGTCCCGTATAATCAAAGGT
AACGTACCACGGATAGGCTCCCGG -> ACGTACCACGGATAGGCTCCCGGA
TCGCAGAACCGGGGCGACCCTGAA -> CGCAGAACCGGGGCGACCCTGAAT
GGGCCCATATAATTCTCGACTTAG -> GGCCCATATAATTCTCGACTTAGC
CTATCCCCCTAACGTAATCATGGC -> TATCCCCCTAACGTAATCATGGCT
GTGAGGGAAAGCTCCACTGAGCGC -> TGAGGGAAAGCTCCACTGAGCGCT
GTACTAATTCGGCTACTAAAGACT -> TACTAATTCGGCTACTAAAGACTT
GTGCAAGCACCTATAAGCGGAGGC -> TGCAAGCACCTATAAGCGGAGGCC
ATCTCAGTCGAGGTAGTTACGATA -> TCTCAGTCGAGGTAGTTACGATAG
GGTCGTATCCCCAACACGTGGAAA -> GTCGTATCCCCAACACGTGGAAAT
CAGATCGTCCCACGGGTGGCTACC -> AGATCGTCCCACGGGTGGCTACCG
TAGCGCAGTGATAACTAGCCACCC -> AGCGCAGTGATAACTAGCCACCCC
CTGAATTAACAGGTCGTATCCCCA -> TGAATTAACAGGTCGTATCCCCAA
AGGTTCAGAGCAGTACCCAAGCCT -> GGTTCAGAGCAGTACCCAAGCCTA
CGTATCCCCAACACGTGGAAATCG -> GTATCCCCAACACGTGGAAATCGA
CCAAGCCCTTAGTAAAACAAACTA -> CAAGCCCTTAGTAAAACAAACTAT
TGATACAGCAGCGCCCGACGCACC -> GATACAGCAGCGCCCGACGCACCT
AAGGCATAGCCGTCGAGCCAAGCT -> AGGCATAGCCGTCGAGCCAAGCTG
GGTTCAGAGCAGTACCCAAGCCTA -> GTTCAGAGCAGTACCCAAGCCTAG
TCTGTTTGCCGAGGTAGAGAAATT -> CTGTTTGCCGAGGTAGAGAAATTC
AAGCCTACACTAGTCCAGAGTAGG -> AGCCTACACTAGTCCAGAGTAGGT
ACCACGGATAGGCTCCCGGATTGG -> CCACGGATAGGCTCCCGGATTGGC
CTAGCTGGTTTGTACTAATTCGGC -> TAGCTGGTTTGTACTAATTCGGCT
CATCACTATTGCCGCTGGAGAGGA -> ATCACTATTGCCGCTGGAGAGGAT
CTGCTAACTACGGTGCTATCCCCC -> TGCTAACTACGGTGCTATCCCCCT
GTATCTTGAACCAAAACTGTTATT -> TATCTTGAACCAAAACTGTTATTT
TGGGCATTAAGCAGTGAAATATCC -> GGGCATTAAGCAGTGAAATATCCG
CGAAAGCCTACACTAGTCCAGAGT -> GAAAGCCTACACTAGTCCAGAGTA
GGTGTCATACCGTGATTTGATACA -> GTGTCATACCGTGATTTGATACAG
CTGAGCGCTCTAGCGCAGTGATAA -> TGAGCGCTCTAGCGCAGTGATAAC
AGCGCTCTAGCGCAGTGATAACTA -> GCGCTCTAGCGCAGTGATAACTAG
TCTTAAGTAACATTGAACCACGCT -> CTTAAGTAACATTGAACCACGCTT
TCCTCCGGTGTCATACCGTGATTT -> CCTCCGGTGTCATACCGTGATTTG
AAATGGGTCTATTATTTTTTGCTC -> AATGGGTCTATTATTTTTTGCTCT
TCTGCTAACTACGGTGCTATCCCC -> CTGCTAACTACGGTGCTATCCCCC
ATCCGGTTTAAGTTCGCACGACAG -> TCCGGTTTAAGTTCGCACGACAGG
ACCGTCGCAGGAATAGAAATGGGT -> CCGTCGCAGGAATAGAAATGGGTC
GCATTATGGGGTACGTGACTACGT -> CATTATGGGGTACGTGACTACGTG
CGCGGGCAGAGACATCGGATCCAG -> GCGGGCAGAGACATCGGATCCAGT
TGTGCTAACTGCACGGTGAGGGAA -> GTGCTAACTGCACGGTGAGGGAAA
TATACCATCCCATCAGATCGTCCC -> ATACCATCCCATCAGATCGTCCCA
GACTTGTGCTATAGTAACACCTGG -> ACTTGTGCTATAGTAACACCTGGC
GTGGAATTAGGTTATCCAGATCTA -> TGGAATTAGGTTATCCAGATCTAC
CGTACTGTGCGACCGTAAACCTGT -> GTACTGTGCGACCGTAAACCTGTC
CCGGATTACATGGGTTCGGTTTAA -> CGGATTACATGGGTTCGGTTTAAC
GAACCACGCTTGTGCTAACTGCAC -> AACCACGCTTGTGCTAACTGCACG
CGTCGAAAATTAGGAAAAATACGA -> GTCGAAAATTAGGAAAAATACGAC
TGAACATATCGTACGATGCTACAA -> GAACATATCGTACGATGCTACAAT
ATTATTTTTTGCTCTAGGAGCATC -> TTATTTTTTGCTCTAGGAGCATCT
AGTTCGAAAGTATTGGACCTGCCC -> GTTCGAAAGTATTGGACCTGCCCC
GGATTACATGGGTTCGGTTTAACT -> GATTACATGGGTTCGGTTTAACTA
TCCAACAGCCCGCCCTCAATGATC -> CCAACAGCCCGCCCTCAATGATCT
CGAATCGGGTCAGGTCACGAGCTC -> GAATCGGGTCAGGTCACGAGCTCC
TGCACGACGTAGGGAACGCGATTC -> GCACGACGTAGGGAACGCGATTCG
GAAAGCCTACACTAGTCCAGAGTA -> AAAGCCTACACTAGTCCAGAGTAG
CTGCTATTTGAACTCTCGGGGAGA -> TGCTATTTGAACTCTCGGGGAGAA
ATCCTTAAGGTAATTACGACGTCA -> TCCTTAAGGTAATTACGACGTCAA
TGAGTTGTGAGGTACATAGCCCCC -> GAGTTGTGAGGTACATAGCCCCCT
CCGGGTGTCTGGCAGATTACTCTA -> CGGGTGTCTGGCAGATTACTCTAC
CTACAAGTCATCTCCTCCGGTGTC -> TACAAGTCATCTCCTCCGGTGTCA
CCTAGTGCAAAGAGAACCAATGGC -> CTAGTGCAAAGAGAACCAATGGCC
CCAAATGAATATACACGCTACAGG -> CAAATGAATATACACGCTACAGGA
ATCAGCGAGCGTGCGAACAAGGCC -> TCAGCGAGCGTGCGAACAAGGCCC
TGCTCCCGTCTCCAAGGCGTGGGA -> GCTCCCGTCTCCAAGGCGTGGGAG
AGAGACATCGGATCCAGTCTGCTA -> GAGACATCGGATCCAGTCTGCTAA
AAATCGCCGGAGGCGTCTGAGAGT -> AATCGCCGGAGGCGTCTGAGAGTT
CTGGCCCGGGTGTCTGGCAGATTA -> TGGCCCGGGTGTCTGGCAGATTAC
GGGCAGAGACATCGGATCCAGTCT -> GGCAGAGACATCGGATCCAGTCTG
TCCAGATCTACCCAGTTAAGAGCT -> CCAGATCTACCCAGTTAAGAGCTC
TGCCGGTCATGACCTGCTATTTGA -> GCCGGTCATGACCTGCTATTTGAA
TCCCATCTGGCTGCAGGGGGCCTA -> CCCATCTGGCTGCAGGGGGCCTAA
ATCACCTGCCGATCGAAAGGCCTC -> TCACCTGCCGATCGAAAGGCCTCT
GCCCCGTAGGCGTACAAAACTCTC -> CCCCGTAGGCGTACAAAACTCTCA
ACAGGACATCTACGGTGGTCCGGA -> CAGGACATCTACGGTGGTCCGGAT
ATCACTTCTACATGCCTATTTCGC -> TCACTTCTACATGCCTATTTCGCG
CGCTGGAGAGGATAATCACCTGCC -> GCTGGAGAGGATAATCACCTGCCG
CTGTCACCTGGCCCGGGTGTCTGG -> TGTCACCTGGCCCGGGTGTCTGGC
AACAGCCCGCCCTCAATGATCTGC -> ACAGCCCGCCCTCAATGATCTGCC
AACTCTACGGTCCCGTATAATCAA -> ACTCTACGGTCCCGTATAATCAAA
GCAGCTCAGTCGCCGGGTAGGCAT -> CAGCTCAGTCGCCGGGTAGGCATG
ACCGATGTGGCCAAGGTACACACG -> CCGATGTGGCCAAGGTACACACGT
GCTACGGCCAACGTAAAACTCCCC -> CTACGGCCAACGTAAAACTCCCCC
GCCCAATGGTCCAACAGCCCGCCC -> CCCAATGGTCCAACAGCCCGCCCT
AGTGAACATATCGTACGATGCTAC -> GTGAACATATCGTACGATGCTACA
TAGGGAATTGAGTTTGTGGCGCGT -> AGGGAATTGAGTTTGTGGCGCGTA
ACGGTGAGGGAAAGCTCCACTGAG -> CGGTGAGGGAAAGCTCCACTGAGC
CAGGGGGCCTAAGCCTGCCGGTAC -> AGGGGGCCTAAGCCTGCCGGTACT
ACTTAGTATTCCGACTTCGCTAGA -> CTTAGTATTCCGACTTCGCTAGAC
AACAAACTATGAATTGTACTAGCC -> ACAAACTATGAATTGTACTAGCCT
GAACTCTCGGGGAGAATTGTAACT -> AACTCTCGGGGAGAATTGTAACTC
TTAACACGTAGTCAACATGGTCTA -> TAACACGTAGTCAACATGGTCTAC
TCCCAAGGTCGAGAGCAATAACAG -> CCCAAGGTCGAGAGCAATAACAGC
TGTGGCGCGTAGTAGTAGGTATAA -> GTGGCGCGTAGTAGTAGGTATAAC
TAGAAATGGGTCTATTATTTTTTG -> AGAAATGGGTCTATTATTTTTTGC
GTAAGCAATCATTCAGAAATCGCC -> TAAGCAATCATTCAGAAATCGCCG
TTAAGAGCTCCTGCAGACGCTTCT -> TAAGAGCTCCTGCAGACGCTTCTA
GCGCAGTGATAACTAGCCACCCCC -> CGCAGTGATAACTAGCCACCCCCA
CTCCCGGATTGGCAAAACTGCCGG -> TCCCGGATTGGCAAAACTGCCGGT
ACGCTTGTGCTAACTGCACGGTGA -> CGCTTGTGCTAACTGCACGGTGAG
GTATTGGACCTGCCCCCTACCGGC -> TATTGGACCTGCCCCCTACCGGCC
GTATCTCCGCCGCGGGCAGAGACA -> TATCTCCGCCGCGGGCAGAGACAT
TGCCGAGTAAGCAATCATTCAGAA -> GCCGAGTAAGCAATCATTCAGAAA
CGCAGTGATAACTAGCCACCCCCA -> GCAGTGATAACTAGCCACCCCCAT
CGAGCGTGCGAACAAGGCCCAATG -> GAGCGTGCGAACAAGGCCCAATGG
AAACGGCTTCGCAGAACCGGGGCG -> AACGGCTTCGCAGAACCGGGGCGA
AAATACGACTTGTGCTATAGTAAC -> AATACGACTTGTGCTATAGTAACA
GTATCTGTTTGCCGAGGTAGAGAA -> TATCTGTTTGCCGAGGTAGAGAAA
GCCTGCCCGGAATGCAATACGCGT -> CCTGCCCGGAATGCAATACGCGTC
CTCCCCGTTACCCAGGTGAGAGCA -> TCCCCGTTACCCAGGTGAGAGCAT
CCCATCTGGCTGCAGGGGGCCTAA -> CCATCTGGCTGCAGGGGGCCTAAG
AAAGAGAACCAATGGCCTCACGCC -> AAGAGAACCAATGGCCTCACGCCA
AGTTCGCGTCAGAGGTTAGGTTGC -> GTTCGCGTCAGAGGTTAGGTTGCG
AACACCTGGCACGCCAGACACAAG -> ACACCTGGCACGCCAGACACAAGA
GCTTATTGGGTGCAAGCACCTATA -> CTTATTGGGTGCAAGCACCTATAA
TCGGGGAGAATTGTAACTCTACGG -> CGGGGAGAATTGTAACTCTACGGT
CGCTCCCTTAAGGCATAGCCGTCG -> GCTCCCTTAAGGCATAGCCGTCGA
AATGGCCTCACGCCAAGCCCTTAG -> ATGGCCTCACGCCAAGCCCTTAGT
GGGGCCTAAGCCTGCCGGTACTGC -> GGGCCTAAGCCTGCCGGTACTGCA
GGCAAAACTGCCGGTCATGACCTG -> GCAAAACTGCCGGTCATGACCTGC
CTACCCAGTTAAGAGCTCCTGCAG -> TACCCAGTTAAGAGCTCCTGCAGA
TGGAATTAGGTTATCCAGATCTAC -> GGAATTAGGTTATCCAGATCTACC
AGAGAAATTCTCGCCCACTACGAA -> GAGAAATTCTCGCCCACTACGAAA
GAAGGACACTAGACGATGGACGGT -> AAGGACACTAGACGATGGACGGTT
CATCAGATCGTCCCACGGGTGGCT -> ATCAGATCGTCCCACGGGTGGCTA
ACGCGCATTGCTTCCGCGCGAATC -> CGCGCATTGCTTCCGCGCGAATCG
GCATGGGTTTGGGGTGGAATTAGG -> CATGGGTTTGGGGTGGAATTAGGT
CCATCACTTCTACATGCCTATTTC -> CATCACTTCTACATGCCTATTTCG
GCTTCGCAGAACCGGGGCGACCCT -> CTTCGCAGAACCGGGGCGACCCTG
CGAGGTAGTTACGATAGTGGCCGT -> GAGGTAGTTACGATAGTGGCCGTA
CAAAGGTCGGCGGTCCCAAGGTCG -> AAAGGTCGGCGGTCCCAAGGTCGA
GTGATAACTAGCCACCCCCATTGC -> TGATAACTAGCCACCCCCATTGCG
GGGAACCCTTCTGGTGATCTTAAG -> GGAACCCTTCTGGTGATCTTAAGT
CAAGGTCGAGAGCAATAACAGCAT -> AAGGTCGAGAGCAATAACAGCATT
GATAGAGTTCATATAGGGCCCATA -> ATAGAGTTCATATAGGGCCCATAT
CAGGAACCCCTATCGTAAATCTCA -> AGGAACCCCTATCGTAAATCTCAG
GGACCTGCCCCCTACCGGCCATCA -> GACCTGCCCCCTACCGGCCATCAC
CCCAGGTGAGAGCATAGTGAACAT -> CCAGGTGAGAGCATAGTGAACATA
AGCCTACAAGTCATCTCCTCCGGT -> GCCTACAAGTCATCTCCTCCGGTG
TGTGAGGTACATAGCCCCCTCCTT -> GTGAGGTACATAGCCCCCTCCTTC
AGTTTGTGGCGCGTAGTAGTAGGT -> GTTTGTGGCGCGTAGTAGTAGGTA
AGAAGCATCGTCGAAAATTAGGAA -> GAAGCATCGTCGAAAATTAGGAAA
ACAGCATTTGTCGGGGAACCCTTC -> CAGCATTTGTCGGGGAACCCTTCT
AATCGACTTTCGTTGGATGCTAGA -> ATCGACTTTCGTTGGATGCTAGAG
TGTAACTCTACGGTCCCGTATAAT -> GTAACTCTACGGTCCCGTATAATC
CCGCATCGCAGGAACCCCTATCGT -> CGCATCGCAGGAACCCCTATCGTA
CCATATAATTCTCGACTTAGCTGC -> CATATAATTCTCGACTTAGCTGCT
CGGTCATGACCTGCTATTTGAACT -> GGTCATGACCTGCTATTTGAACTC
ACCTGCTATTTGAACTCTCGGGGA -> CCTGCTATTTGAACTCTCGGGGAG
GTCCGGGAGTTCGCGTCAGAGGTT -> TCCGGGAGTTCGCGTCAGAGGTTA
GTGGGAGATCCATCACTTCTACAT -> TGGGAGATCCATCACTTCTACATG
GCCGAGTAAGCAATCATTCAGAAA -> CCGAGTAAGCAATCATTCAGAAAT
TTGGGTGCAAGCACCTATAAGCGG -> TGGGTGCAAGCACCTATAAGCGGA
CCGGGTAGGCATGGGTTTGGGGTG -> CGGGTAGGCATGGGTTTGGGGTGG
ACGATTCGCCGTGCCTATACCATC -> CGATTCGCCGTGCCTATACCATCC
CCGGGGCGACCCTGAATGCATTAT -> CGGGGCGACCCTGAATGCATTATG
GTCGTATCCCCAACACGTGGAAAT -> TCGTATCCCCAACACGTGGAAATC
GCTCTAGCGCAGTGATAACTAGCC -> CTCTAGCGCAGTGATAACTAGCCA
CTGTGCGACCGTAAACCTGTCACC -> TGTGCGACCGTAAACCTGTCACCT
CCAGACACAAGATAGAGTTCATAT -> CAGACACAAGATAGAGTTCATATA
CGTGACTACGTGGGCTACGGCCAA -> GTGACTACGTGGGCTACGGCCAAC
TAGAGAAATTCTCGCCCACTACGA -> AGAGAAATTCTCGCCCACTACGAA
TCGAGAGCAATAACAGCATTTGTC -> CGAGAGCAATAACAGCATTTGTCG
GAGCGCTCTAGCGCAGTGATAACT -> AGCGCTCTAGCGCAGTGATAACTA
TTGCTCTAGGAGCATCTGACGTTA -> TGCTCTAGGAGCATCTGACGTTAT
CACTATTGCCGCTGGAGAGGATAA -> ACTATTGCCGCTGGAGAGGATAAT
GTCTGAGAGTTGTTAGTATCTGTT -> TCTGAGAGTTGTTAGTATCTGTTT
AACTGCACGGTGAGGGAAAGCTCC -> ACTGCACGGTGAGGGAAAGCTCCA
AATGATCTGCCATCTGGGCATTAA -> ATGATCTGCCATCTGGGCATTAAG
GGGGTACGTGACTACGTGGGCTAC -> GGGTACGTGACTACGTGGGCTACG
AGTTAAACGGCTTCGCAGAACCGG -> GTTAAACGGCTTCGCAGAACCGGG
GTACTAGCCTACAAGTCATCTCCT -> TACTAGCCTACAAGTCATCTCCTC
TCCAGAGTAGGTTCAGAGCAGTAC -> CCAGAGTAGGTTCAGAGCAGTACC
CCCTAACGTAATCATGGCTGAGAA -> CCTAACGTAATCATGGCTGAGAAG
GTTGCGTAAACCGATGTGGCCAAG -> TTGCGTAAACCGATGTGGCCAAGG
TGCTAGAGAGAAAGTCACACTGAC -> GCTAGAGAGAAAGTCACACTGACC
GCTCCACTGAGCGCTCTAGCGCAG -> CTCCACTGAGCGCTCTAGCGCAGT
AGGCATAGCCGTCGAGCCAAGCTG -> GGCATAGCCGTCGAGCCAAGCTGC
GCAGTGAAATATCCGCATCGCAGG -> CAGTGAAATATCCGCATCGCAGGA
GTGCTAACTGCACGGTGAGGGAAA -> TGCTAACTGCACGGTGAGGGAAAG
CTCATTGCGCTCTGCGATCATCCG -> TCATTGCGCTCTGCGATCATCCGG
TATCTTGAACCAAAACTGTTATTT -> ATCTTGAACCAAAACTGTTATTTG
CAGGTCGTATCCCCAACACGTGGA -> AGGTCGTATCCCCAACACGTGGAA
CTAGCCTACAAGTCATCTCCTCCG -> TAGCCTACAAGTCATCTCCTCCGG
CACCTTAGGCCCCGTAGGCGTACA -> ACCTTAGGCCCCGTAGGCGTACAA
TCCCGGATTGGCAAAACTGCCGGT -> CCCGGATTGGCAAAACTGCCGGTC
AATTAACAGGTCGTATCCCCAACA -> ATTAACAGGTCGTATCCCCAACAC
CTCCCCCTGCTTCGCTTCAGATCA -> TCCCCCTGCTTCGCTTCAGATCAT
GAATTGTAACTCTACGGTCCCGTA -> AATTGTAACTCTACGGTCCCGTAT
TCATTGCGCTCTGCGATCATCCGG -> CATTGCGCTCTGCGATCATCCGGT
TTCGCAGAACCGGGGCGACCCTGA -> TCGCAGAACCGGGGCGACCCTGAA
TACGTAACTAGCTGGTTTGTACTA -> ACGTAACTAGCTGGTTTGTACTAA
GAGTTGTTAGTATCTGTTTGCCGA -> AGTTGTTAGTATCTGTTTGCCGAG
TTGATACAGCAGCGCCCGACGCAC -> TGATACAGCAGCGCCCGACGCACC
CATCAGCGAGCGTGCGAACAAGGC -> ATCAGCGAGCGTGCGAACAAGGCC
TCTAGCGCAGTGATAACTAGCCAC -> CTAGCGCAGTGATAACTAGCCACC
GCATCGTCGAAAATTAGGAAAAAT -> CATCGTCGAAAATTAGGAAAAATA
AATCGCCGGAGGCGTCTGAGAGTT -> ATCGCCGGAGGCGTCTGAGAGTTG
TACGTGGTATCTCATTGCGCTCTG -> ACGTGGTATCTCATTGCGCTCTGC
CCGGTGTCATACCGTGATTTGATA -> CGGTGTCATACCGTGATTTGATAC
CAACATGGTCTACAAACTTTCCGT -> AACATGGTCTACAAACTTTCCGTA
TGCGAATTGACGCTCCCTTAAGGC -> GCGAATTGACGCTCCCTTAAGGCA
CTAAAGACTTGCTGAATTAACAGG -> TAAAGACTTGCTGAATTAACAGGT
AGTCGCCGGGTAGGCATGGGTTTG -> GTCGCCGGGTAGGCATGGGTTTGG
TACGGTCCCGTATAATCAAAGGTC -> ACGGTCCCGTATAATCAAAGGTCG
CTCCCTTAAGGCATAGCCGTCGAG -> TCCCTTAAGGCATAGCCGTCGAGC
GCCGTGCCTATACCATCCCATCAG -> CCGTGCCTATACCATCCCATCAGA
GTTCAGAGCAGTACCCAAGCCTAG -> TTCAGAGCAGTACCCAAGCCTAGT
CTCCCTCATCGGTTGCGTAAACCG -> TCCCTCATCGGTTGCGTAAACCGA
GGAGCATCTGACGTTATAGTTCGA -> GAGCATCTGACGTTATAGTTCGAA
TTGTCGGGGAACCCTTCTGGTGAT -> TGTCGGGGAACCCTTCTGGTGATC
ACCTGGCACGCCAGACACAAGATA -> CCTGGCACGCCAGACACAAGATAG
AGCGTGCGAACAAGGCCCAATGGT -> GCGTGCGAACAAGGCCCAATGGTC
GTGAGGTACATAGCCCCCTCCTTC -> TGAGGTACATAGCCCCCTCCTTCC
CGACTTGTGCTATAGTAACACCTG -> GACTTGTGCTATAGTAACACCTGG
AAGTAACATTGAACCACGCTTGTG -> AGTAACATTGAACCACGCTTGTGC
CATCTACGGTGGTCCGGATTACAT -> ATCTACGGTGGTCCGGATTACATG
ATCTGGCTGCAGGGGGCCTAAGCC -> TCTGGCTGCAGGGGGCCTAAGCCT
AGCGCCCGACGCACCTTAGGCCCC -> GCGCCCGACGCACCTTAGGCCCCG
CCCTGAATGCATTATGGGGTACGT -> CCTGAATGCATTATGGGGTACGTG
GCCGGAGGCGTCTGAGAGTTGTTA -> CCGGAGGCGTCTGAGAGTTGTTAG
AACTTAGTATTCCGACTTCGCTAG -> ACTTAGTATTCCGACTTCGCTAGA
CGGAGGCATAACTTAGTATTCCGA -> GGAGGCATAACTTAGTATTCCGAC
ATACCATCCCATCAGATCGTCCCA -> TACCATCCCATCAGATCGTCCCAC
CGTGGTTGCTCCCGTCTCCAAGGC -> GTGGTTGCTCCCGTCTCCAAGGCG
AACATTGAACCACGCTTGTGCTAA -> ACATTGAACCACGCTTGTGCTAAC
TGCGACCGTAAACCTGTCACCTGG -> GCGACCGTAAACCTGTCACCTGGC
ATTCAGAAATCGCCGGAGGCGTCT -> TTCAGAAATCGCCGGAGGCGTCTG
ATATCCGCATCGCAGGAACCCCTA -> TATCCGCATCGCAGGAACCCCTAT
AGAGCATAGTGAACATATCGTACG -> GAGCATAGTGAACATATCGTACGA
TCTAGTAAACGTACTGTGCGACCG -> CTAGTAAACGTACTGTGCGACCGT
TCGTACGATGCTACAATCTGCGCC -> CGTACGATGCTACAATCTGCGCCC
GGTGAGAGCATAGTGAACATATCG -> GTGAGAGCATAGTGAACATATCGT
AAACTGTTATTTGCCTGCCCGGAA -> AACTGTTATTTGCCTGCCCGGAAT
CCCGGAGGCATAACTTAGTATTCC -> CCGGAGGCATAACTTAGTATTCCG
GGTGGTCCGGATTACATGGGTTCG -> GTGGTCCGGATTACATGGGTTCGG
GCTCCCGGATTGGCAAAACTGCCG -> CTCCCGGATTGGCAAAACTGCCGG
GAGTTCATATAGGGCCCATATAAT -> AGTTCATATAGGGCCCATATAATT
GGTTTGGGGTGGAATTAGGTTATC -> GTTTGGGGTGGAATTAGGTTATCC
TCGTCCCACGGGTGGCTACCGTCA -> CGTCCCACGGGTGGCTACCGTCAA
ACAGCCCGCCCTCAATGATCTGCC -> CAGCCCGCCCTCAATGATCTGCCA
GGTATCTCATTGCGCTCTGCGATC -> GTATCTCATTGCGCTCTGCGATCA
GGACGGTTGCCGAGTAAGCAATCA -> GACGGTTGCCGAGTAAGCAATCAT
AACGTAAAACTCCCCCTGCTTCGC -> ACGTAAAACTCCCCCTGCTTCGCT
TCGGTTTAACTACTCCCCGTTACC -> CGGTTTAACTACTCCCCGTTACCC
GATCCAGTCTGCTAACTACGGTGC -> ATCCAGTCTGCTAACTACGGTGCT
CTATTATTTTTTGCTCTAGGAGCA -> TATTATTTTTTGCTCTAGGAGCAT
ATTGGGTGCAAGCACCTATAAGCG -> TTGGGTGCAAGCACCTATAAGCGG
ATCGTACGATGCTACAATCTGCGC -> TCGTACGATGCTACAATCTGCGCC
TAGGTTATCCAGATCTACCCAGTT -> AGGTTATCCAGATCTACCCAGTTA
TTCGTTTTTAACACGTAGTCAACA -> TCGTTTTTAACACGTAGTCAACAT
CCTTAGTAAAACAAACTATGAATT -> CTTAGTAAAACAAACTATGAATTG
ATATACACGCTACAGGACATCTAC -> TATACACGCTACAGGACATCTACG
AGCCCCCTCCTTCCCGTGGTTGCT -> GCCCCCTCCTTCCCGTGGTTGCTC
GCAGACGCTTCTAGTAAACGTACT -> CAGACGCTTCTAGTAAACGTACTG
AGCGAGCGTGCGAACAAGGCCCAA -> GCGAGCGTGCGAACAAGGCCCAAT
TATGAATTGTACTAGCCTACAAGT -> ATGAATTGTACTAGCCTACAAGTC
TATCTCATTGCGCTCTGCGATCAT -> ATCTCATTGCGCTCTGCGATCATC
AGCCTAGTGCAAAGAGAACCAATG -> GCCTAGTGCAAAGAGAACCAATGG
GCGCCCGGAGGCATAACTTAGTAT -> CGCCCGGAGGCATAACTTAGTATT
GACTACGTGGGCTACGGCCAACGT -> ACTACGTGGGCTACGGCCAACGTA
CAGAACCGGGGCGACCCTGAATGC -> AGAACCGGGGCGACCCTGAATGCA
TCAGATCATACGATTCGCCGTGCC -> CAGATCATACGATTCGCCGTGCCT
AGTGCAAAGAGAACCAATGGCCTC -> GTGCAAAGAGAACCAATGGCCTCA
TTAAGTAACATTGAACCACGCTTG -> TAAGTAACATTGAACCACGCTTGT
CTGGAGAGGATAATCACCTGCCGA -> TGGAGAGGATAATCACCTGCCGAT
TCGACTTTCGTTGGATGCTAGAGA -> CGACTTTCGTTGGATGCTAGAGAG
ATAGTAACACCTGGCACGCCAGAC -> TAGTAACACCTGGCACGCCAGACA
TCCCCAACACGTGGAAATCGACTT -> CCCCAACACGTGGAAATCGACTTT
GCCCACTACGAAAGCCTACACTAG -> CCCACTACGAAAGCCTACACTAGT
GGTACGTGACTACGTGGGCTACGG -> GTACGTGACTACGTGGGCTACGGC
AAGTCATCTCCTCCGGTGTCATAC -> AGTCATCTCCTCCGGTGTCATACC
TAGTATCTGTTTGCCGAGGTAGAG -> AGTATCTGTTTGCCGAGGTAGAGA
TCACCTGCCGATCGAAAGGCCTCT -> CACCTGCCGATCGAAAGGCCTCTC
GCCGCGGGCAGAGACATCGGATCC -> CCGCGGGCAGAGACATCGGATCCA
ACTTACGTAACTAGCTGGTTTGTA -> CTTACGTAACTAGCTGGTTTGTAC
ACGCGATTCGTTTTTAACACGTAG -> CGCGATTCGTTTTTAACACGTAGT
TCGCGTCAGAGGTTAGGTTGCGAA -> CGCGTCAGAGGTTAGGTTGCGAAT
GGTCTACAAACTTTCCGTATTCCA -> GTCTACAAACTTTCCGTATTCCAT
CAGATTACTCTACCCCGGGCCAAA -> AGATTACTCTACCCCGGGCCAAAT
GATTGGCAAAACTGCCGGTCATGA -> ATTGGCAAAACTGCCGGTCATGAC
GGGTGCAAGCACCTATAAGCGGAG -> GGTGCAAGCACCTATAAGCGGAGG
AGCGGAGGCCTTAGGGAATTGAGT -> GCGGAGGCCTTAGGGAATTGAGTT
CCAAAACTGTTATTTGCCTGCCCG -> CAAAACTGTTATTTGCCTGCCCGG
ACTAAAGACTTGCTGAATTAACAG -> CTAAAGACTTGCTGAATTAACAGG
ACGTCAAAACGTACCACGGATAGG -> CGTCAAAACGTACCACGGATAGGC
CCAACAGCCCGCCCTCAATGATCT -> CAACAGCCCGCCCTCAATGATCTG
AGAGTTCATATAGGGCCCATATAA -> GAGTTCATATAGGGCCCATATAAT
CTGCACGGTGAGGGAAAGCTCCAC -> TGCACGGTGAGGGAAAGCTCCACT
GTAAACCTGTCACCTGGCCCGGGT -> TAAACCTGTCACCTGGCCCGGGTG
ATAGTGAACATATCGTACGATGCT -> TAGTGAACATATCGTACGATGCTA
AGTGAAATATCCGCATCGCAGGAA -> GTGAAATATCCGCATCGCAGGAAC
CGGGTAGGCATGGGTTTGGGGTGG -> GGGTAGGCATGGGTTTGGGGTGGA
AATATACACGCTACAGGACATCTA -> ATATACACGCTACAGGACATCTAC
TAGACGATGGACGGTTGCCGAGTA -> AGACGATGGACGGTTGCCGAGTAA
GTATTCCGACTTCGCTAGACTTAC -> TATTCCGACTTCGCTAGACTTACG
TATTATTTTTTGCTCTAGGAGCAT -> ATTATTTTTTGCTCTAGGAGCATC
GGGAAAGCTCCACTGAGCGCTCTA -> GGAAAGCTCCACTGAGCGCTCTAG
TGAATTAACAGGTCGTATCCCCAA -> GAATTAACAGGTCGTATCCCCAAC
CGACTTGAACGCGCATTGCTTCCG -> GACTTGAACGCGCATTGCTTCCGC
AGGTTATCCAGATCTACCCAGTTA -> GGTTATCCAGATCTACCCAGTTAA
GGTGCAAGCACCTATAAGCGGAGG -> GTGCAAGCACCTATAAGCGGAGGC
GTCGAAAATTAGGAAAAATACGAC -> TCGAAAATTAGGAAAAATACGACT
TGCGAACAAGGCCCAATGGTCCAA -> GCGAACAAGGCCCAATGGTCCAAC
AAAACTGCCGGTCATGACCTGCTA -> AAACTGCCGGTCATGACCTGCTAT
TGAGGTACATAGCCCCCTCCTTCC -> GAGGTACATAGCCCCCTCCTTCCC
AAAGTCACACTGACCCGTACGTGG -> AAGTCACACTGACCCGTACGTGGT
GCATTGCTTCCGCGCGAATCGGGT -> CATTGCTTCCGCGCGAATCGGGTC
AGGTAGTTACGATAGTGGCCGTAA -> GGTAGTTACGATAGTGGCCGTAAG
CACTAGTCCAGAGTAGGTTCAGAG -> ACTAGTCCAGAGTAGGTTCAGAGC
TGGTTTGTACTAATTCGGCTACTA -> GGTTTGTACTAATTCGGCTACTAA
CGGAGGCGTCTGAGAGTTGTTAGT -> GGAGGCGTCTGAGAGTTGTTAGTA
CGATGCTACAATCTGCGCCCGGAG -> GATGCTACAATCTGCGCCCGGAGG
CCGTTACCCAGGTGAGAGCATAGT -> CGTTACCCAGGTGAGAGCATAGTG
CGTAGGCGTACAAAACTCTCAGTT -> GTAGGCGTACAAAACTCTCAGTTA
CCACTACGAAAGCCTACACTAGTC -> CACTACGAAAGCCTACACTAGTCC
GTGGCGCGTAGTAGTAGGTATAAC -> TGGCGCGTAGTAGTAGGTATAACT
CTCTACGGTCCCGTATAATCAAAG -> TCTACGGTCCCGTATAATCAAAGG
TCGAAAGGCCTCTCCCTCATCGGT -> CGAAAGGCCTCTCCCTCATCGGTT
ATACACGCTACAGGACATCTACGG -> TACACGCTACAGGACATCTACGGT
GAATTAACAGGTCGTATCCCCAAC -> AATTAACAGGTCGTATCCCCAACA
TCCCACGGGTGGCTACCGTCAATG -> CCCACGGGTGGCTACCGTCAATGA
TGCTATCCCCCTAACGTAATCATG -> GCTATCCCCCTAACGTAATCATGG
AGCCACCCCCATTGCGTTGTATCT -> GCCACCCCCATTGCGTTGTATCTT
GTGGCTACCGTCAATGAGTTGTGA -> TGGCTACCGTCAATGAGTTGTGAG
TAACAGGTCGTATCCCCAACACGT -> AACAGGTCGTATCCCCAACACGTG
CCGGTACTGCACGACGTAGGGAAC -> CGGTACTGCACGACGTAGGGAACG
GCATCGCAGGAACCCCTATCGTAA -> CATCGCAGGAACCCCTATCGTAAA
TAGCCCCCTCCTTCCCGTGGTTGC -> AGCCCCCTCCTTCCCGTGGTTGCT
TAGGAAAAATACGACTTGTGCTAT -> AGGAAAAATACGACTTGTGCTATA
TAGGTTGCGAATTGACGCTCCCTT -> AGGTTGCGAATTGACGCTCCCTTA
GGCTGCAGGGGGCCTAAGCCTGCC -> GCTGCAGGGGGCCTAAGCCTGCCG
CGTCGCAGGAATAGAAATGGGTCT -> GTCGCAGGAATAGAAATGGGTCTA
GTGGCCAAGGTACACACGTATCTC -> TGGCCAAGGTACACACGTATCTCC
ACTTCAGTCCGGGAGTTCGCGTCA -> CTTCAGTCCGGGAGTTCGCGTCAG
CCTGCCCCCTACCGGCCATCACTA -> CTGCCCCCTACCGGCCATCACTAT
CTAGTGCAAAGAGAACCAATGGCC -> TAGTGCAAAGAGAACCAATGGCCT
CAGTCGAGGTAGTTACGATAGTGG -> AGTCGAGGTAGTTACGATAGTGGC
AACCACGCTTGTGCTAACTGCACG -> ACCACGCTTGTGCTAACTGCACGG
GAGCATAGTGAACATATCGTACGA -> AGCATAGTGAACATATCGTACGAT
AATAGAAATGGGTCTATTATTTTT -> ATAGAAATGGGTCTATTATTTTTT
GAAATGGGTCTATTATTTTTTGCT -> AAATGGGTCTATTATTTTTTGCTC
ATAATTCTCGACTTAGCTGCTTAT -> TAATTCTCGACTTAGCTGCTTATT
GCGAACAAGGCCCAATGGTCCAAC -> CGAACAAGGCCCAATGGTCCAACA
CTGGTTTGTACTAATTCGGCTACT -> TGGTTTGTACTAATTCGGCTACTA
ACGGCTTCGCAGAACCGGGGCGAC -> CGGCTTCGCAGAACCGGGGCGACC
GACGCTTCTAGTAAACGTACTGTG -> ACGCTTCTAGTAAACGTACTGTGC
ACCATCCCATCAGATCGTCCCACG -> CCATCCCATCAGATCGTCCCACGG
AGGCCTCTCCCTCATCGGTTGCGT -> GGCCTCTCCCTCATCGGTTGCGTA
AGTATTCCGACTTCGCTAGACTTA -> GTATTCCGACTTCGCTAGACTTAC
ATGCTAGAGAGAAAGTCACACTGA -> TGCTAGAGAGAAAGTCACACTGAC
GCTTCCGCGCGAATCGGGTCAGGT -> CTTCCGCGCGAATCGGGTCAGGTC
CATAACTTAGTATTCCGACTTCGC -> ATAACTTAGTATTCCGACTTCGCT
CTCCTCCGGTGTCATACCGTGATT -> TCCTCCGGTGTCATACCGTGATTT
TTCGGTTTAACTACTCCCCGTTAC -> TCGGTTTAACTACTCCCCGTTACC
GCTAGACTTACGTAACTAGCTGGT -> CTAGACTTACGTAACTAGCTGGTT
GGGAGAATTGTAACTCTACGGTCC -> GGAGAATTGTAACTCTACGGTCCC
AAGCCTAGTGCAAAGAGAACCAAT -> AGCCTAGTGCAAAGAGAACCAATG
TAAGCGGAGGCCTTAGGGAATTGA -> AAGCGGAGGCCTTAGGGAATTGAG
ATAGAGTTCATATAGGGCCCATAT -> TAGAGTTCATATAGGGCCCATATA
CGGCGGTCCCAAGGTCGAGAGCAA -> GGCGGTCCCAAGGTCGAGAGCAAT
CGGCTACTAAAGACTTGCTGAATT -> GGCTACTAAAGACTTGCTGAATTA
ATACAGCAGCGCCCGACGCACCTT -> TACAGCAGCGCCCGACGCACCTTA
TAGTAAACGTACTGTGCGACCGTA -> AGTAAACGTACTGTGCGACCGTAA
CTACGAAAGCCTACACTAGTCCAG -> TACGAAAGCCTACACTAGTCCAGA
TTGTGCTATAGTAACACCTGGCAC -> TGTGCTATAGTAACACCTGGCACG
CGTAGGGAACGCGATTCGTTTTTA -> GTAGGGAACGCGATTCGTTTTTAA
CGCTCTAGCGCAGTGATAACTAGC -> GCTCTAGCGCAGTGATAACTAGCC
CAGCGAGCGTGCGAACAAGGCCCA -> AGCGAGCGTGCGAACAAGGCCCAA
CAAATGAATATACACGCTACAGGA -> AAATGAATATACACGCTACAGGAC
TTAAGTTCGCACGACAGGGAACTT -> TAAGTTCGCACGACAGGGAACTTC
TGGCTGCAGGGGGCCTAAGCCTGC -> GGCTGCAGGGGGCCTAAGCCTGCC
TTAAACGGCTTCGCAGAACCGGGG -> TAAACGGCTTCGCAGAACCGGGGC
TGTATCTTGAACCAAAACTGTTAT -> GTATCTTGAACCAAAACTGTTATT
CCCGTCTCCAAGGCGTGGGAGATC -> CCGTCTCCAAGGCGTGGGAGATCC
CGCCGGAGGCGTCTGAGAGTTGTT -> GCCGGAGGCGTCTGAGAGTTGTTA
CGCACCTTAGGCCCCGTAGGCGTA -> GCACCTTAGGCCCCGTAGGCGTAC
CTAATTCGGCTACTAAAGACTTGC -> TAATTCGGCTACTAAAGACTTGCT
TTGAACTCTCGGGGAGAATTGTAA -> TGAACTCTCGGGGAGAATTGTAAC
ACCACGCTTGTGCTAACTGCACGG -> CCACGCTTGTGCTAACTGCACGGT
TTAAGCAGTGAAATATCCGCATCG -> TAAGCAGTGAAATATCCGCATCGC
ACGTGACTACGTGGGCTACGGCCA -> CGTGACTACGTGGGCTACGGCCAA
GCTCTGCGATCATCCGGTTTAAGT -> CTCTGCGATCATCCGGTTTAAGTT
GATGTGGCCAAGGTACACACGTAT -> ATGTGGCCAAGGTACACACGTATC
GGAGATCCATCACTTCTACATGCC -> GAGATCCATCACTTCTACATGCCT
TCGGCTACTAAAGACTTGCTGAAT -> CGGCTACTAAAGACTTGCTGAATT
ACAGCAGCGCCCGACGCACCTTAG -> CAGCAGCGCCCGACGCACCTTAGG
GGAACGCGATTCGTTTTTAACACG -> GAACGCGATTCGTTTTTAACACGT
CCTGCTTCGCTTCAGATCATACGA -> CTGCTTCGCTTCAGATCATACGAT
TCCCCCTGCTTCGCTTCAGATCAT -> CCCCCTGCTTCGCTTCAGATCATA
CCGGAATGCAATACGCGTCGCAGC -> CGGAATGCAATACGCGTCGCAGCT
TTAGCTGCTTATTGGGTGCAAGCA -> TAGCTGCTTATTGGGTGCAAGCAC
CAAGCCTAGTGCAAAGAGAACCAA -> AAGCCTAGTGCAAAGAGAACCAAT
ACGGTCCCGTATAATCAAAGGTCG -> CGGTCCCGTATAATCAAAGGTCGG
ACTAGACGATGGACGGTTGCCGAG -> CTAGACGATGGACGGTTGCCGAGT
GACTTGAACGCGCATTGCTTCCGC -> ACTTGAACGCGCATTGCTTCCGCG
CGCTTCAGATCATACGATTCGCCG -> GCTTCAGATCATACGATTCGCCGT
TTGAGTTTGTGGCGCGTAGTAGTA -> TGAGTTTGTGGCGCGTAGTAGTAG
GCCTCTCCCTCATCGGTTGCGTAA -> CCTCTCCCTCATCGGTTGCGTAAA
GCTCCCATCTGGCTGCAGGGGGCC -> CTCCCATCTGGCTGCAGGGGGCCT
CCCCGGGCCAAATGAATATACACG -> CCCGGGCCAAATGAATATACACGC
GTGTCTGGCAGATTACTCTACCCC -> TGTCTGGCAGATTACTCTACCCCG
CGGATTACATGGGTTCGGTTTAAC -> GGATTACATGGGTTCGGTTTAACT
GAGAGAAAGTCACACTGACCCGTA -> AGAGAAAGTCACACTGACCCGTAC
GACCTGCTATTTGAACTCTCGGGG -> ACCTGCTATTTGAACTCTCGGGGA
ACGGTTGCCGAGTAAGCAATCATT -> CGGTTGCCGAGTAAGCAATCATTC
GTTCGGTTTAACTACTCCCCGTTA -> TTCGGTTTAACTACTCCCCGTTAC
GAGAACCAATGGCCTCACGCCAAG -> AGAACCAATGGCCTCACGCCAAGC
AGTATTGGACCTGCCCCCTACCGG -> GTATTGGACCTGCCCCCTACCGGC
ACTTAGCTGCTTATTGGGTGCAAG -> CTTAGCTGCTTATTGGGTGCAAGC
CGGAATGCAATACGCGTCGCAGCT -> GGAATGCAATACGCGTCGCAGCTC
GGGAACGCGATTCGTTTTTAACAC -> GGAACGCGATTCGTTTTTAACACG
ACGTGGAAATCGACTTTCGTTGGA -> CGTGGAAATCGACTTTCGTTGGAT
AGTCATCTCCTCCGGTGTCATACC -> GTCATCTCCTCCGGTGTCATACCG
CTGACGTTATAGTTCGAAAGTATT -> TGACGTTATAGTTCGAAAGTATTG
TAAACGGCTTCGCAGAACCGGGGC -> AAACGGCTTCGCAGAACCGGGGCG
AGGTTGCGAATTGACGCTCCCTTA -> GGTTGCGAATTGACGCTCCCTTAA
AGGGCCCATATAATTCTCGACTTA -> GGGCCCATATAATTCTCGACTTAG
GGAGAGGATAATCACCTGCCGATC -> GAGAGGATAATCACCTGCCGATCG
CCCCCATTGCGTTGTATCTTGAAC -> CCCCATTGCGTTGTATCTTGAACC
GATAGGCTCCCGGATTGGCAAAAC -> ATAGGCTCCCGGATTGGCAAAACT
GAGGGAAAGCTCCACTGAGCGCTC -> AGGGAAAGCTCCACTGAGCGCTCT
ACTGTTATTTGCCTGCCCGGAATG -> CTGTTATTTGCCTGCCCGGAATGC
AACATGGTCTACAAACTTTCCGTA -> ACATGGTCTACAAACTTTCCGTAT
CCATCCCATCAGATCGTCCCACGG -> CATCCCATCAGATCGTCCCACGGG
CGGGCAGAGACATCGGATCCAGTC -> GGGCAGAGACATCGGATCCAGTCT
GTCTGGCAGATTACTCTACCCCGG -> TCTGGCAGATTACTCTACCCCGGG
CCTTAAGGTAATTACGACGTCAAA -> CTTAAGGTAATTACGACGTCAAAA
GCATCTGACGTTATAGTTCGAAAG -> CATCTGACGTTATAGTTCGAAAGT
CAGTCTGCTAACTACGGTGCTATC -> AGTCTGCTAACTACGGTGCTATCC
GTCGCAGCTCAGTCGCCGGGTAGG -> TCGCAGCTCAGTCGCCGGGTAGGC
TAAGCAATCATTCAGAAATCGCCG -> AAGCAATCATTCAGAAATCGCCGG
GCTGGAGAGGATAATCACCTGCCG -> CTGGAGAGGATAATCACCTGCCGA
AGAATTGTAACTCTACGGTCCCGT -> GAATTGTAACTCTACGGTCCCGTA
ACTAGCTGGTTTGTACTAATTCGG -> CTAGCTGGTTTGTACTAATTCGGC
ACCCTTCTGGTGATCTTAAGTAAC -> CCCTTCTGGTGATCTTAAGTAACA
CTAACGTAATCATGGCTGAGAAGG -> TAACGTAATCATGGCTGAGAAGGA
GTCGCAGGAATAGAAATGGGTCTA -> TCGCAGGAATAGAAATGGGTCTAT
GACCCTGAATGCATTATGGGGTAC -> ACCCTGAATGCATTATGGGGTACG
TAGGCCCCGTAGGCGTACAAAACT -> AGGCCCCGTAGGCGTACAAAACTC
CCCCTAACGTAATCATGGCTGAGA -> CCCTAACGTAATCATGGCTGAGAA
CCCTCAATGATCTGCCATCTGGGC -> CCTCAATGATCTGCCATCTGGGCA
CTCTACCCCGGGCCAAATGAATAT -> TCTACCCCGGGCCAAATGAATATA
TTATTGGGTGCAAGCACCTATAAG -> TATTGGGTGCAAGCACCTATAAGC
CCCCGTAGGCGTACAAAACTCTCA -> CCCGTAGGCGTACAAAACTCTCAG
AATGGGTCTATTATTTTTTGCTCT -> ATGGGTCTATTATTTTTTGCTCTA
CCTAAGCCTGCCGGTACTGCACGA -> CTAAGCCTGCCGGTACTGCACGAC
CAGCAGCGCCCGACGCACCTTAGG -> AGCAGCGCCCGACGCACCTTAGGC
AAGCAATCATTCAGAAATCGCCGG -> AGCAATCATTCAGAAATCGCCGGA
CGAGTAAGCAATCATTCAGAAATC -> GAGTAAGCAATCATTCAGAAATCG
GCGGGCAGAGACATCGGATCCAGT -> CGGGCAGAGACATCGGATCCAGTC
TAATTCTCGACTTAGCTGCTTATT -> AATTCTCGACTTAGCTGCTTATTG
TCCCGTCTCCAAGGCGTGGGAGAT -> CCCGTCTCCAAGGCGTGGGAGATC
ATCATGGCTGAGAAGGACACTAGA -> TCATGGCTGAGAAGGACACTAGAC
CACTTCTACATGCCTATTTCGCGT -> ACTTCTACATGCCTATTTCGCGTA
TCTTGAACCAAAACTGTTATTTGC -> CTTGAACCAAAACTGTTATTTGCC
TACAAGTCATCTCCTCCGGTGTCA -> ACAAGTCATCTCCTCCGGTGTCAT
CGCAGGAATAGAAATGGGTCTATT -> GCAGGAATAGAAATGGGTCTATTA
TGTGCGACCGTAAACCTGTCACCT -> GTGCGACCGTAAACCTGTCACCTG
AAATCGACTTTCGTTGGATGCTAG -> AATCGACTTTCGTTGGATGCTAGA
GAAATCGCCGGAGGCGTCTGAGAG -> AAATCGCCGGAGGCGTCTGAGAGT
CTTTCGTTGGATGCTAGAGAGAAA -> TTTCGTTGGATGCTAGAGAGAAAG
GTCTCCAAGGCGTGGGAGATCCAT -> TCTCCAAGGCGTGGGAGATCCATC
GAAATTCTCGCCCACTACGAAAGC -> AAATTCTCGCCCACTACGAAAGCC
ACCGTAAACCTGTCACCTGGCCCG -> CCGTAAACCTGTCACCTGGCCCGG
CCCCCTCCTTCCCGTGGTTGCTCC -> CCCCTCCTTCCCGTGGTTGCTCCC
ATCAGATCGTCCCACGGGTGGCTA -> TCAGATCGTCCCACGGGTGGCTAC
AGATCTACCCAGTTAAGAGCTCCT -> GATCTACCCAGTTAAGAGCTCCTG
ACGGATAGGCTCCCGGATTGGCAA -> CGGATAGGCTCCCGGATTGGCAAA
CGGTTTAACTACTCCCCGTTACCC -> GGTTTAACTACTCCCCGTTACCCA
CGTAAATCTCAGTCGAGGTAGTTA -> GTAAATCTCAGTCGAGGTAGTTAC
GCACGACGTAGGGAACGCGATTCG -> CACGACGTAGGGAACGCGATTCGT
TGAATGCATTATGGGGTACGTGAC -> GAATGCATTATGGGGTACGTGACT
GGCGCGTAGTAGTAGGTATAACTT -> GCGCGTAGTAGTAGGTATAACTTA
TCACTATTGCCGCTGGAGAGGATA -> CACTATTGCCGCTGGAGAGGATAA
ACAGGTCGTATCCCCAACACGTGG -> CAGGTCGTATCCCCAACACGTGGA
CGTCGCAGCTCAGTCGCCGGGTAG -> GTCGCAGCTCAGTCGCCGGGTAGG
TAATTACGACGTCAAAACGTACCA -> AATTACGACGTCAAAACGTACCAC
CAGTGATAACTAGCCACCCCCATT -> AGTGATAACTAGCCACCCCCATTG
CCCGTACGTGGTATCTCATTGCGC -> CCGTACGTGGTATCTCATTGCGCT
GTCCGGATTACATGGGTTCGGTTT -> TCCGGATTACATGGGTTCGGTTTA
ACACGTGGAAATCGACTTTCGTTG -> CACGTGGAAATCGACTTTCGTTGG
TGTTAGTATCTGTTTGCCGAGGTA -> GTTAGTATCTGTTTGCCGAGGTAG
GTCAGAGGTTAGGTTGCGAATTGA -> TCAGAGGTTAGGTTGCGAATTGAC
TCTGGCTGCAGGGGGCCTAAGCCT -> CTGGCTGCAGGGGGCCTAAGCCTG
GAGGATAATCACCTGCCGATCGAA -> AGGATAATCACCTGCCGATCGAAA
GGCCTCTCCCTCATCGGTTGCGTA -> GCCTCTCCCTCATCGGTTGCGTAA
GATCGAAAGGCCTCTCCCTCATCG -> ATCGAAAGGCCTCTCCCTCATCGG
TGCTGAATTAACAGGTCGTATCCC -> GCTGAATTAACAGGTCGTATCCCC
CTACAGGACATCTACGGTGGTCCG -> TACAGGACATCTACGGTGGTCCGG
AGAACCAATGGCCTCACGCCAAGC -> GAACCAATGGCCTCACGCCAAGCC
GCCGTAAGTAACCGTCGCAGGAAT -> CCGTAAGTAACCGTCGCAGGAATA
ATTTGTCGGGGAACCCTTCTGGTG -> TTTGTCGGGGAACCCTTCTGGTGA
CGAAAATTAGGAAAAATACGACTT -> GAAAATTAGGAAAAATACGACTTG
GTCGAGAGCAATAACAGCATTTGT -> TCGAGAGCAATAACAGCATTTGTC
CGTCTGAGAGTTGTTAGTATCTGT -> GTCTGAGAGTTGTTAGTATCTGTT
GGGTCTATTATTTTTTGCTCTAGG -> GGTCTATTATTTTTTGCTCTAGGA
GCTTCAGATCATACGATTCGCCGT -> CTTCAGATCATACGATTCGCCGTG
TTTCCGTATTCCATCAGCGAGCGT -> TTCCGTATTCCATCAGCGAGCGTG
CATCGTCGAAAATTAGGAAAAATA -> ATCGTCGAAAATTAGGAAAAATAC
CCCCCTACCGGCCATCACTATTGC -> CCCCTACCGGCCATCACTATTGCC
AAAAATACGACTTGTGCTATAGTA -> AAAATACGACTTGTGCTATAGTAA
TGGCCAAGGTACACACGTATCTCC -> GGCCAAGGTACACACGTATCTCCG
GTCATCTCCTCCGGTGTCATACCG -> TCATCTCCTCCGGTGTCATACCGT
AAACCTGTCACCTGGCCCGGGTGT -> AACCTGTCACCTGGCCCGGGTGTC
CGCCAAGCCCTTAGTAAAACAAAC -> GCCAAGCCCTTAGTAAAACAAACT
TCAGATCGTCCCACGGGTGGCTAC -> CAGATCGTCCCACGGGTGGCTACC
GAGCGTGCGAACAAGGCCCAATGG -> AGCGTGCGAACAAGGCCCAATGGT
TTAAGGTAATTACGACGTCAAAAC -> TAAGGTAATTACGACGTCAAAACG
ATCTCATTGCGCTCTGCGATCATC -> TCTCATTGCGCTCTGCGATCATCC
GTTGTTAGTATCTGTTTGCCGAGG -> TTGTTAGTATCTGTTTGCCGAGGT
GGTTGCTCCCGTCTCCAAGGCGTG -> GTTGCTCCCGTCTCCAAGGCGTGG
AATCTCAGTCGAGGTAGTTACGAT -> ATCTCAGTCGAGGTAGTTACGATA
GATGGACGGTTGCCGAGTAAGCAA -> ATGGACGGTTGCCGAGTAAGCAAT
GTCCCAAGGTCGAGAGCAATAACA -> TCCCAAGGTCGAGAGCAATAACAG
GTCCAGAGTAGGTTCAGAGCAGTA -> TCCAGAGTAGGTTCAGAGCAGTAC
CGGTCCCGTATAATCAAAGGTCGG -> GGTCCCGTATAATCAAAGGTCGGC
TCCCGTATAATCAAAGGTCGGCGG -> CCCGTATAATCAAAGGTCGGCGGT
CGAGCTCCCATCTGGCTGCAGGGG -> GAGCTCCCATCTGGCTGCAGGGGG
CACTACGAAAGCCTACACTAGTCC -> ACTACGAAAGCCTACACTAGTCCA
ACTAGTCCAGAGTAGGTTCAGAGC -> CTAGTCCAGAGTAGGTTCAGAGCA
TCCAGTCTGCTAACTACGGTGCTA -> CCAGTCTGCTAACTACGGTGCTAT
CTACGGCCAACGTAAAACTCCCCC -> TACGGCCAACGTAAAACTCCCCCT
GGCCGTAAGTAACCGTCGCAGGAA -> GCCGTAAGTAACCGTCGCAGGAAT
TTAGTATTCCGACTTCGCTAGACT -> TAGTATTCCGACTTCGCTAGACTT
AGTGATAACTAGCCACCCCCATTG -> GTGATAACTAGCCACCCCCATTGC
TCGTCGAAAATTAGGAAAAATACG -> CGTCGAAAATTAGGAAAAATACGA
ACATGGGTTCGGTTTAACTACTCC -> CATGGGTTCGGTTTAACTACTCCC
GCCGATCGAAAGGCCTCTCCCTCA -> CCGATCGAAAGGCCTCTCCCTCAT
GGAAAGCTCCACTGAGCGCTCTAG -> GAAAGCTCCACTGAGCGCTCTAGC
TGCAAAGAGAACCAATGGCCTCAC -> GCAAAGAGAACCAATGGCCTCACG
GGCCCATATAATTCTCGACTTAGC -> GCCCATATAATTCTCGACTTAGCT
AACAGCATTTGTCGGGGAACCCTT -> ACAGCATTTGTCGGGGAACCCTTC
GCTGCAGGGGGCCTAAGCCTGCCG -> CTGCAGGGGGCCTAAGCCTGCCGG
GTGGCCGTAAGTAACCGTCGCAGG -> TGGCCGTAAGTAACCGTCGCAGGA
TGCTCTAGGAGCATCTGACGTTAT -> GCTCTAGGAGCATCTGACGTTATA
CTAACTACGGTGCTATCCCCCTAA -> TAACTACGGTGCTATCCCCCTAAC
TAGTCAACATGGTCTACAAACTTT -> AGTCAACATGGTCTACAAACTTTC
ATGGGTTCGGTTTAACTACTCCCC -> TGGGTTCGGTTTAACTACTCCCCG
CAAGATAGAGTTCATATAGGGCCC -> AAGATAGAGTTCATATAGGGCCCA
TCTCCCTCATCGGTTGCGTAAACC -> CTCCCTCATCGGTTGCGTAAACCG
GAATTGAGTTTGTGGCGCGTAGTA -> AATTGAGTTTGTGGCGCGTAGTAG
CAAGTCATCTCCTCCGGTGTCATA -> AAGTCATCTCCTCCGGTGTCATAC
CCAGTCTGCTAACTACGGTGCTAT -> CAGTCTGCTAACTACGGTGCTATC
CTGCTTATTGGGTGCAAGCACCTA -> TGCTTATTGGGTGCAAGCACCTAT
ATACGATTCGCCGTGCCTATACCA -> TACGATTCGCCGTGCCTATACCAT
GCACCTTAGGCCCCGTAGGCGTAC -> CACCTTAGGCCCCGTAGGCGTACA
CTTCTGGTGATCTTAAGTAACATT -> TTCTGGTGATCTTAAGTAACATTG
GGTTTAACTACTCCCCGTTACCCA -> GTTTAACTACTCCCCGTTACCCAG
CGTTATAGTTCGAAAGTATTGGAC -> GTTATAGTTCGAAAGTATTGGACC
CTTAGGGAATTGAGTTTGTGGCGC -> TTAGGGAATTGAGTTTGTGGCGCG
CTACCGGCCATCACTATTGCCGCT -> TACCGGCCATCACTATTGCCGCTG
CTGGGCATTAAGCAGTGAAATATC -> TGGGCATTAAGCAGTGAAATATCC
TATCTGTTTGCCGAGGTAGAGAAA -> ATCTGTTTGCCGAGGTAGAGAAAT
TCGTTTTTAACACGTAGTCAACAT -> CGTTTTTAACACGTAGTCAACATG
ATGAATTGTACTAGCCTACAAGTC -> TGAATTGTACTAGCCTACAAGTCA
CAAACTATGAATTGTACTAGCCTA -> AAACTATGAATTGTACTAGCCTAC
TCAGAGGTTAGGTTGCGAATTGAC -> CAGAGGTTAGGTTGCGAATTGACG
AGAGGATAATCACCTGCCGATCGA -> GAGGATAATCACCTGCCGATCGAA
ACGGTGGTCCGGATTACATGGGTT -> CGGTGGTCCGGATTACATGGGTTC
TACACGCTACAGGACATCTACGGT -> ACACGCTACAGGACATCTACGGTG
GATTACTCTACCCCGGGCCAAATG -> ATTACTCTACCCCGGGCCAAATGA
TTATCCAGATCTACCCAGTTAAGA -> TATCCAGATCTACCCAGTTAAGAG
CGCCCACTACGAAAGCCTACACTA -> GCCCACTACGAAAGCCTACACTAG
CAATCATTCAGAAATCGCCGGAGG -> AATCATTCAGAAATCGCCGGAGGC
CCGTCGAGCCAAGCTGCGAGCCAC -> CGTCGAGCCAAGCTGCGAGCCACT
TTTTTGCTCTAGGAGCATCTGACG -> TTTTGCTCTAGGAGCATCTGACGT
TATTGGGTGCAAGCACCTATAAGC -> ATTGGGTGCAAGCACCTATAAGCG
ACTTGAACGCGCATTGCTTCCGCG -> CTTGAACGCGCATTGCTTCCGCGC
GTCCCGTATAATCAAAGGTCGGCG -> TCCCGTATAATCAAAGGTCGGCGG
CTTGAACCAAAACTGTTATTTGCC -> TTGAACCAAAACTGTTATTTGCCT
AGAGAACCAATGGCCTCACGCCAA -> GAGAACCAATGGCCTCACGCCAAG
AATCACCTGCCGATCGAAAGGCCT -> ATCACCTGCCGATCGAAAGGCCTC
GGCAGATTACTCTACCCCGGGCCA -> GCAGATTACTCTACCCCGGGCCAA
AATTCTCGCCCACTACGAAAGCCT -> ATTCTCGCCCACTACGAAAGCCTA
GGAATGCAATACGCGTCGCAGCTC -> GAATGCAATACGCGTCGCAGCTCA
GCGCATTGCTTCCGCGCGAATCGG -> CGCATTGCTTCCGCGCGAATCGGG
AAGGACACTAGACGATGGACGGTT -> AGGACACTAGACGATGGACGGTTG
GTAGGCATGGGTTTGGGGTGGAAT -> TAGGCATGGGTTTGGGGTGGAATT
GGCACGCCAGACACAAGATAGAGT -> GCACGCCAGACACAAGATAGAGTT
TGTACTAGCCTACAAGTCATCTCC -> GTACTAGCCTACAAGTCATCTCCT
GCGTACAAAACTCTCAGTTAAACG -> CGTACAAAACTCTCAGTTAAACGG
CGTCAATGAGTTGTGAGGTACATA -> GTCAATGAGTTGTGAGGTACATAG
AGGACATCTACGGTGGTCCGGATT -> GGACATCTACGGTGGTCCGGATTA
TGGGGTGGAATTAGGTTATCCAGA -> GGGGTGGAATTAGGTTATCCAGAT
GCCTTAGGGAATTGAGTTTGTGGC -> CCTTAGGGAATTGAGTTTGTGGCG
CGGGCCAAATGAATATACACGCTA -> GGGCCAAATGAATATACACGCTAC
CAAAACTGTTATTTGCCTGCCCGG -> AAAACTGTTATTTGCCTGCCCGGA
CTGGCACGCCAGACACAAGATAGA -> TGGCACGCCAGACACAAGATAGAG
CCCATTGCGTTGTATCTTGAACCA -> CCATTGCGTTGTATCTTGAACCAA
GGCCTAAGCCTGCCGGTACTGCAC -> GCCTAAGCCTGCCGGTACTGCACG
CGTAATCATGGCTGAGAAGGACAC -> GTAATCATGGCTGAGAAGGACACT
TGGCTGAGAAGGACACTAGACGAT -> GGCTGAGAAGGACACTAGACGATG
AACCAAAACTGTTATTTGCCTGCC -> ACCAAAACTGTTATTTGCCTGCCC
GGAGAATTGTAACTCTACGGTCCC -> GAGAATTGTAACTCTACGGTCCCG
TTGAACCACGCTTGTGCTAACTGC -> TGAACCACGCTTGTGCTAACTGCA
GCGAATCGGGTCAGGTCACGAGCT -> CGAATCGGGTCAGGTCACGAGCTC
CCAGTTAAGAGCTCCTGCAGACGC -> CAGTTAAGAGCTCCTGCAGACGCT
GTGAACATATCGTACGATGCTACA -> TGAACATATCGTACGATGCTACAA
TGCTTATTGGGTGCAAGCACCTAT -> GCTTATTGGGTGCAAGCACCTATA
CACGCTACAGGACATCTACGGTGG -> ACGCTACAGGACATCTACGGTGGT
ATATAATTCTCGACTTAGCTGCTT -> TATAATTCTCGACTTAGCTGCTTA
GTAGTCAACATGGTCTACAAACTT -> TAGTCAACATGGTCTACAAACTTT
ACGTTATAGTTCGAAAGTATTGGA -> CGTTATAGTTCGAAAGTATTGGAC
CTACTCCCCGTTACCCAGGTGAGA -> TACTCCCCGTTACCCAGGTGAGAG
CTCGGGGAGAATTGTAACTCTACG -> TCGGGGAGAATTGTAACTCTACGG
TTCGCGTCAGAGGTTAGGTTGCGA -> TCGCGTCAGAGGTTAGGTTGCGAA
ACCCCTATCGTAAATCTCAGTCGA -> CCCCTATCGTAAATCTCAGTCGAG
GTTTAAGTTCGCACGACAGGGAAC -> TTTAAGTTCGCACGACAGGGAACT
CGACCGTAAACCTGTCACCTGGCC -> GACCGTAAACCTGTCACCTGGCCC
TTCATATAGGGCCCATATAATTCT -> TCATATAGGGCCCATATAATTCTC
AGGTCGTATCCCCAACACGTGGAA -> GGTCGTATCCCCAACACGTGGAAA
GTCATGACCTGCTATTTGAACTCT -> TCATGACCTGCTATTTGAACTCTC
CTGCCATCTGGGCATTAAGCAGTG -> TGCCATCTGGGCATTAAGCAGTGA
CGTTGTATCTTGAACCAAAACTGT -> GTTGTATCTTGAACCAAAACTGTT
GGGGCGACCCTGAATGCATTATGG -> GGGCGACCCTGAATGCATTATGGG
ACTCTCGGGGAGAATTGTAACTCT -> CTCTCGGGGAGAATTGTAACTCTA
TGACGTTATAGTTCGAAAGTATTG -> GACGTTATAGTTCGAAAGTATTGG
GCTCCCTTAAGGCATAGCCGTCGA -> CTCCCTTAAGGCATAGCCGTCGAG
GCGAGCGTGCGAACAAGGCCCAAT -> CGAGCGTGCGAACAAGGCCCAATG
CGCGTATCCTTAAGGTAATTACGA -> GCGTATCCTTAAGGTAATTACGAC
CCGGTTTAAGTTCGCACGACAGGG -> CGGTTTAAGTTCGCACGACAGGGA
TAGGGCCCATATAATTCTCGACTT -> AGGGCCCATATAATTCTCGACTTA
GGAATAGAAATGGGTCTATTATTT -> GAATAGAAATGGGTCTATTATTTT
TTACCCAGGTGAGAGCATAGTGAA -> TACCCAGGTGAGAGCATAGTGAAC
TAATCATGGCTGAGAAGGACACTA -> AATCATGGCTGAGAAGGACACTAG
GTAAACCGATGTGGCCAAGGTACA -> TAAACCGATGTGGCCAAGGTACAC
CCACGGATAGGCTCCCGGATTGGC -> CACGGATAGGCTCCCGGATTGGCA
CGCGTCGCAGCTCAGTCGCCGGGT -> GCGTCGCAGCTCAGTCGCCGGGTA
CTCTCCCTCATCGGTTGCGTAAAC -> TCTCCCTCATCGGTTGCGTAAACC
TGGTCCGGATTACATGGGTTCGGT -> GGTCCGGATTACATGGGTTCGGTT
ATCGAAAGGCCTCTCCCTCATCGG -> TCGAAAGGCCTCTCCCTCATCGGT
ATAGGCTCCCGGATTGGCAAAACT -> TAGGCTCCCGGATTGGCAAAACTG
TCCGGGAGTTCGCGTCAGAGGTTA -> CCGGGAGTTCGCGTCAGAGGTTAG
TAGGCTCCCGGATTGGCAAAACTG -> AGGCTCCCGGATTGGCAAAACTGC
GACATCGGATCCAGTCTGCTAACT -> ACATCGGATCCAGTCTGCTAACTA
TACGATAGTGGCCGTAAGTAACCG -> ACGATAGTGGCCGTAAGTAACCGT
TAACTTAACGACTTGAACGCGCAT -> AACTTAACGACTTGAACGCGCATT
AAATCTCAGTCGAGGTAGTTACGA -> AATCTCAGTCGAGGTAGTTACGAT
TCAAAACGTACCACGGATAGGCTC -> CAAAACGTACCACGGATAGGCTCC
TCCCCGTTACCCAGGTGAGAGCAT -> CCCCGTTACCCAGGTGAGAGCATA
AGCTGGTTTGTACTAATTCGGCTA -> GCTGGTTTGTACTAATTCGGCTAC
CTTAAGGTAATTACGACGTCAAAA -> TTAAGGTAATTACGACGTCAAAAC
GCAGTACCCAAGCCTAGTGCAAAG -> CAGTACCCAAGCCTAGTGCAAAGA
TACTGTGCGACCGTAAACCTGTCA -> ACTGTGCGACCGTAAACCTGTCAC
TACTAAAGACTTGCTGAATTAACA -> ACTAAAGACTTGCTGAATTAACAG
TCGCAGGAATAGAAATGGGTCTAT -> CGCAGGAATAGAAATGGGTCTATT
CGGCCATCACTATTGCCGCTGGAG -> GGCCATCACTATTGCCGCTGGAGA
TCATACCGTGATTTGATACAGCAG -> CATACCGTGATTTGATACAGCAGC
GCGGAGGCCTTAGGGAATTGAGTT -> CGGAGGCCTTAGGGAATTGAGTTT
GAGGTTAGGTTGCGAATTGACGCT -> AGGTTAGGTTGCGAATTGACGCTC
GCAAAACTGCCGGTCATGACCTGC -> CAAAACTGCCGGTCATGACCTGCT
CCCTGCTTCGCTTCAGATCATACG -> CCTGCTTCGCTTCAGATCATACGA
TACAAAACTCTCAGTTAAACGGCT -> ACAAAACTCTCAGTTAAACGGCTT
GAATGCAATACGCGTCGCAGCTCA -> AATGCAATACGCGTCGCAGCTCAG
CTCCCATCTGGCTGCAGGGGGCCT -> TCCCATCTGGCTGCAGGGGGCCTA
CATAGCCCCCTCCTTCCCGTGGTT -> ATAGCCCCCTCCTTCCCGTGGTTG
GCGCGTAGTAGTAGGTATAACTTA -> CGCGTAGTAGTAGGTATAACTTAA
CATAGCCGTCGAGCCAAGCTGCGA -> ATAGCCGTCGAGCCAAGCTGCGAG
GCAGGAACCCCTATCGTAAATCTC -> CAGGAACCCCTATCGTAAATCTCA
CTCTAGCGCAGTGATAACTAGCCA -> TCTAGCGCAGTGATAACTAGCCAC
GTAGGTATAACTTAACGACTTGAA -> TAGGTATAACTTAACGACTTGAAC
TATCTCCGCCGCGGGCAGAGACAT -> ATCTCCGCCGCGGGCAGAGACATC
GATAACTAGCCACCCCCATTGCGT -> ATAACTAGCCACCCCCATTGCGTT
GTGGAAATCGACTTTCGTTGGATG -> TGGAAATCGACTTTCGTTGGATGC
GTTGTATCTTGAACCAAAACTGTT -> TTGTATCTTGAACCAAAACTGTTA
ACGACGTAGGGAACGCGATTCGTT -> CGACGTAGGGAACGCGATTCGTTT
GTACTGCACGACGTAGGGAACGCG -> TACTGCACGACGTAGGGAACGCGA
ACGTATCTCCGCCGCGGGCAGAGA -> CGTATCTCCGCCGCGGGCAGAGAC
TACTGCACGACGTAGGGAACGCGA -> ACTGCACGACGTAGGGAACGCGAT
TCGAGCCAAGCTGCGAGCCACTCC -> CGAGCCAAGCTGCGAGCCACTCCT
CAATGATCTGCCATCTGGGCATTA -> AATGATCTGCCATCTGGGCATTAA
CCCGTTACCCAGGTGAGAGCATAG -> CCGTTACCCAGGTGAGAGCATAGT
CACAAGATAGAGTTCATATAGGGC -> ACAAGATAGAGTTCATATAGGGCC
TAGGAGCATCTGACGTTATAGTTC -> AGGAGCATCTGACGTTATAGTTCG
AACTATGAATTGTACTAGCCTACA -> ACTATGAATTGTACTAGCCTACAA
GCAATACGCGTCGCAGCTCAGTCG -> CAATACGCGTCGCAGCTCAGTCGC
ACTACGAAAGCCTACACTAGTCCA -> CTACGAAAGCCTACACTAGTCCAG
TAGAGTTCATATAGGGCCCATATA -> AGAGTTCATATAGGGCCCATATAA
AAGCAGTGAAATATCCGCATCGCA -> AGCAGTGAAATATCCGCATCGCAG
CTCAGTCGCCGGGTAGGCATGGGT -> TCAGTCGCCGGGTAGGCATGGGTT
GGTCTATTATTTTTTGCTCTAGGA -> GTCTATTATTTTTTGCTCTAGGAG
AGGGAACTTCAGTCCGGGAGTTCG -> GGGAACTTCAGTCCGGGAGTTCGC
GTTATAGTTCGAAAGTATTGGACC -> TTATAGTTCGAAAGTATTGGACCT
CGGTCCCAAGGTCGAGAGCAATAA -> GGTCCCAAGGTCGAGAGCAATAAC
TAAAACTCCCCCTGCTTCGCTTCA -> AAAACTCCCCCTGCTTCGCTTCAG
GTTGTGAGGTACATAGCCCCCTCC -> TTGTGAGGTACATAGCCCCCTCCT
TACAAACTTTCCGTATTCCATCAG -> ACAAACTTTCCGTATTCCATCAGC
AGGCATGGGTTTGGGGTGGAATTA -> GGCATGGGTTTGGGGTGGAATTAG
ACTGTGCGACCGTAAACCTGTCAC -> CTGTGCGACCGTAAACCTGTCACC
ATAGTGGCCGTAAGTAACCGTCGC -> TAGTGGCCGTAAGTAACCGTCGCA
AGATTACTCTACCCCGGGCCAAAT -> GATTACTCTACCCCGGGCCAAATG
AGCATTTGTCGGGGAACCCTTCTG -> GCATTTGTCGGGGAACCCTTCTGG
CACGACGTAGGGAACGCGATTCGT -> ACGACGTAGGGAACGCGATTCGTT
CCAATGGCCTCACGCCAAGCCCTT -> CAATGGCCTCACGCCAAGCCCTTA
CGCATCGCAGGAACCCCTATCGTA -> GCATCGCAGGAACCCCTATCGTAA
ATCTCCTCCGGTGTCATACCGTGA -> TCTCCTCCGGTGTCATACCGTGAT
TATCCCCCTAACGTAATCATGGCT -> ATCCCCCTAACGTAATCATGGCTG
TTATTTGCCTGCCCGGAATGCAAT -> TATTTGCCTGCCCGGAATGCAATA
CAGACACAAGATAGAGTTCATATA -> AGACACAAGATAGAGTTCATATAG
ATCTGCCATCTGGGCATTAAGCAG -> TCTGCCATCTGGGCATTAAGCAGT
GACCTGCCCCCTACCGGCCATCAC -> ACCTGCCCCCTACCGGCCATCACT
AGGATAATCACCTGCCGATCGAAA -> GGATAATCACCTGCCGATCGAAAG
TCGCAGGAACCCCTATCGTAAATC -> CGCAGGAACCCCTATCGTAAATCT
CGCGTCAGAGGTTAGGTTGCGAAT -> GCGTCAGAGGTTAGGTTGCGAATT
GCGCTCTGCGATCATCCGGTTTAA -> CGCTCTGCGATCATCCGGTTTAAG
ATCGTCCCACGGGTGGCTACCGTC -> TCGTCCCACGGGTGGCTACCGTCA
TAACAGCATTTGTCGGGGAACCCT -> AACAGCATTTGTCGGGGAACCCTT
GAGATCCATCACTTCTACATGCCT -> AGATCCATCACTTCTACATGCCTA
CATTGAACCACGCTTGTGCTAACT -> ATTGAACCACGCTTGTGCTAACTG
ACATTGAACCACGCTTGTGCTAAC -> CATTGAACCACGCTTGTGCTAACT
CGTGATTTGATACAGCAGCGCCCG -> GTGATTTGATACAGCAGCGCCCGA
GACGTCAAAACGTACCACGGATAG -> ACGTCAAAACGTACCACGGATAGG
TCAACATGGTCTACAAACTTTCCG -> CAACATGGTCTACAAACTTTCCGT
ACTGCACGGTGAGGGAAAGCTCCA -> CTGCACGGTGAGGGAAAGCTCCAC
GCAGATTACTCTACCCCGGGCCAA -> CAGATTACTCTACCCCGGGCCAAA
TAGGCGTACAAAACTCTCAGTTAA -> AGGCGTACAAAACTCTCAGTTAAA
AATCAAAGGTCGGCGGTCCCAAGG -> ATCAAAGGTCGGCGGTCCCAAGGT
CGGTGCTATCCCCCTAACGTAATC -> GGTGCTATCCCCCTAACGTAATCA
ACCCGTACGTGGTATCTCATTGCG -> CCCGTACGTGGTATCTCATTGCGC
CAATACGCGTCGCAGCTCAGTCGC -> AATACGCGTCGCAGCTCAGTCGCC
ATCGCCGGAGGCGTCTGAGAGTTG -> TCGCCGGAGGCGTCTGAGAGTTGT
CACGGTGAGGGAAAGCTCCACTGA -> ACGGTGAGGGAAAGCTCCACTGAG
ATCCCCCTAACGTAATCATGGCTG -> TCCCCCTAACGTAATCATGGCTGA
TATAATTCTCGACTTAGCTGCTTA -> ATAATTCTCGACTTAGCTGCTTAT
CATTAAGCAGTGAAATATCCGCAT -> ATTAAGCAGTGAAATATCCGCATC
CCCATATAATTCTCGACTTAGCTG -> CCATATAATTCTCGACTTAGCTGC
TTGCGTAAACCGATGTGGCCAAGG -> TGCGTAAACCGATGTGGCCAAGGT
ATTCGGCTACTAAAGACTTGCTGA -> TTCGGCTACTAAAGACTTGCTGAA
ACGACTTGAACGCGCATTGCTTCC -> CGACTTGAACGCGCATTGCTTCCG
AGACTTGCTGAATTAACAGGTCGT -> GACTTGCTGAATTAACAGGTCGTA
CCTCATCGGTTGCGTAAACCGATG -> CTCATCGGTTGCGTAAACCGATGT
TAGGTATAACTTAACGACTTGAAC -> AGGTATAACTTAACGACTTGAACG
TTAGGTTGCGAATTGACGCTCCCT -> TAGGTTGCGAATTGACGCTCCCTT
GTGCCTATACCATCCCATCAGATC -> TGCCTATACCATCCCATCAGATCG
GCCCGGAATGCAATACGCGTCGCA -> CCCGGAATGCAATACGCGTCGCAG
GACCCGTACGTGGTATCTCATTGC -> ACCCGTACGTGGTATCTCATTGCG
AGGTAATTACGACGTCAAAACGTA -> GGTAATTACGACGTCAAAACGTAC
CGGGAGTTCGCGTCAGAGGTTAGG -> GGGAGTTCGCGTCAGAGGTTAGGT
CGACGCACCTTAGGCCCCGTAGGC -> GACGCACCTTAGGCCCCGTAGGCG
AAAACGTACCACGGATAGGCTCCC -> AAACGTACCACGGATAGGCTCCCG
TACAGGACATCTACGGTGGTCCGG -> ACAGGACATCTACGGTGGTCCGGA
TAATCAAAGGTCGGCGGTCCCAAG -> AATCAAAGGTCGGCGGTCCCAAGG
AGACTTACGTAACTAGCTGGTTTG -> GACTTACGTAACTAGCTGGTTTGT
TAGTGAACATATCGTACGATGCTA -> AGTGAACATATCGTACGATGCTAC
CCCCGTTACCCAGGTGAGAGCATA -> CCCGTTACCCAGGTGAGAGCATAG
GTCAATGAGTTGTGAGGTACATAG -> TCAATGAGTTGTGAGGTACATAGC
ACTTGCTGAATTAACAGGTCGTAT -> CTTGCTGAATTAACAGGTCGTATC
CCTTCCCGTGGTTGCTCCCGTCTC -> CTTCCCGTGGTTGCTCCCGTCTCC
CAAGCTGCGAGCCACTCCTCTACG -> AAGCTGCGAGCCACTCCTCTACGC
CCCACTACGAAAGCCTACACTAGT -> CCACTACGAAAGCCTACACTAGTC
TCGCTAGACTTACGTAACTAGCTG -> CGCTAGACTTACGTAACTAGCTGG
AGTCTGCTAACTACGGTGCTATCC -> GTCTGCTAACTACGGTGCTATCCC
AGCATCTGACGTTATAGTTCGAAA -> GCATCTGACGTTATAGTTCGAAAG
CGCGCATTGCTTCCGCGCGAATCG -> GCGCATTGCTTCCGCGCGAATCGG
CAAAACTGCCGGTCATGACCTGCT -> AAAACTGCCGGTCATGACCTGCTA
GGTATAACTTAACGACTTGAACGC -> GTATAACTTAACGACTTGAACGCG
ATGAGTTGTGAGGTACATAGCCCC -> TGAGTTGTGAGGTACATAGCCCCC
AGATCGTCCCACGGGTGGCTACCG -> GATCGTCCCACGGGTGGCTACCGT
TTCAGTCCGGGAGTTCGCGTCAGA -> TCAGTCCGGGAGTTCGCGTCAGAG
TGGTATCTCATTGCGCTCTGCGAT -> GGTATCTCATTGCGCTCTGCGATC
AACTTTCCGTATTCCATCAGCGAG -> ACTTTCCGTATTCCATCAGCGAGC
TGGAGAGGATAATCACCTGCCGAT -> GGAGAGGATAATCACCTGCCGATC
TCTACCCCGGGCCAAATGAATATA -> CTACCCCGGGCCAAATGAATATAC
AATTGAGTTTGTGGCGCGTAGTAG -> ATTGAGTTTGTGGCGCGTAGTAGT
CTTAGTAAAACAAACTATGAATTG -> TTAGTAAAACAAACTATGAATTGT
CCGTAAGTAACCGTCGCAGGAATA -> CGTAAGTAACCGTCGCAGGAATAG
TCGGGGAACCCTTCTGGTGATCTT -> CGGGGAACCCTTCTGGTGATCTTA
ACGTAGTCAACATGGTCTACAAAC -> CGTAGTCAACATGGTCTACAAACT
CGTGCGAACAAGGCCCAATGGTCC -> GTGCGAACAAGGCCCAATGGTCCA
GAACTTCAGTCCGGGAGTTCGCGT -> AACTTCAGTCCGGGAGTTCGCGTC
ATTGCCGCTGGAGAGGATAATCAC -> TTGCCGCTGGAGAGGATAATCACC
AAACTGCCGGTCATGACCTGCTAT -> AACTGCCGGTCATGACCTGCTATT
GAAGCATCGTCGAAAATTAGGAAA -> AAGCATCGTCGAAAATTAGGAAAA
ATCCAGATCTACCCAGTTAAGAGC -> TCCAGATCTACCCAGTTAAGAGCT
ATCGCAGGAACCCCTATCGTAAAT -> TCGCAGGAACCCCTATCGTAAATC
ACAAACTATGAATTGTACTAGCCT -> CAAACTATGAATTGTACTAGCCTA
GTAACTCTACGGTCCCGTATAATC -> TAACTCTACGGTCCCGTATAATCA
TCTGCGATCATCCGGTTTAAGTTC -> CTGCGATCATCCGGTTTAAGTTCG
GTTACGATAGTGGCCGTAAGTAAC -> TTACGATAGTGGCCGTAAGTAACC
TGAACTCTCGGGGAGAATTGTAAC -> GAACTCTCGGGGAGAATTGTAACT
TGAGTTTGTGGCGCGTAGTAGTAG -> GAGTTTGTGGCGCGTAGTAGTAGG
GCTTCTAGTAAACGTACTGTGCGA -> CTTCTAGTAAACGTACTGTGCGAC
GACGATGGACGGTTGCCGAGTAAG -> ACGATGGACGGTTGCCGAGTAAGC
TTCTACATGCCTATTTCGCGTATC -> TCTACATGCCTATTTCGCGTATCC
CGGATTGGCAAAACTGCCGGTCAT -> GGATTGGCAAAACTGCCGGTCATG
AATTCGGCTACTAAAGACTTGCTG -> ATTCGGCTACTAAAGACTTGCTGA
GCATAGTGAACATATCGTACGATG -> CATAGTGAACATATCGTACGATGC
CGTGGTATCTCATTGCGCTCTGCG -> GTGGTATCTCATTGCGCTCTGCGA
TGGCTACCGTCAATGAGTTGTGAG -> GGCTACCGTCAATGAGTTGTGAGG
CGTATAATCAAAGGTCGGCGGTCC -> GTATAATCAAAGGTCGGCGGTCCC
TTAGGTTATCCAGATCTACCCAGT -> TAGGTTATCCAGATCTACCCAGTT
GGCCAAGGTACACACGTATCTCCG -> GCCAAGGTACACACGTATCTCCGC
GGCCCCGTAGGCGTACAAAACTCT -> GCCCCGTAGGCGTACAAAACTCTC
GGTTCGGTTTAACTACTCCCCGTT -> GTTCGGTTTAACTACTCCCCGTTA
GGGAGATCCATCACTTCTACATGC -> GGAGATCCATCACTTCTACATGCC
CCGGAGGCATAACTTAGTATTCCG -> CGGAGGCATAACTTAGTATTCCGA
TCTGGTGATCTTAAGTAACATTGA -> CTGGTGATCTTAAGTAACATTGAA
CGAACAAGGCCCAATGGTCCAACA -> GAACAAGGCCCAATGGTCCAACAG
ACCCTGAATGCATTATGGGGTACG -> CCCTGAATGCATTATGGGGTACGT
ATCACTATTGCCGCTGGAGAGGAT -> TCACTATTGCCGCTGGAGAGGATA
TCCTTCCCGTGGTTGCTCCCGTCT -> CCTTCCCGTGGTTGCTCCCGTCTC
CCGTGCCTATACCATCCCATCAGA -> CGTGCCTATACCATCCCATCAGAT
AACAAGGCCCAATGGTCCAACAGC -> ACAAGGCCCAATGGTCCAACAGCC
CATGGGTTCGGTTTAACTACTCCC -> ATGGGTTCGGTTTAACTACTCCCC
GCTGGTTTGTACTAATTCGGCTAC -> CTGGTTTGTACTAATTCGGCTACT
ACCAAAACTGTTATTTGCCTGCCC -> CCAAAACTGTTATTTGCCTGCCCG
CGGCCAACGTAAAACTCCCCCTGC -> GGCCAACGTAAAACTCCCCCTGCT
CTCCTTCCCGTGGTTGCTCCCGTC -> TCCTTCCCGTGGTTGCTCCCGTCT
ACTAGCCTACAAGTCATCTCCTCC -> CTAGCCTACAAGTCATCTCCTCCG
TGACCCGTACGTGGTATCTCATTG -> GACCCGTACGTGGTATCTCATTGC
CACGTGGAAATCGACTTTCGTTGG -> ACGTGGAAATCGACTTTCGTTGGA
CTTGTGCTAACTGCACGGTGAGGG -> TTGTGCTAACTGCACGGTGAGGGA
CATCGCAGGAACCCCTATCGTAAA -> ATCGCAGGAACCCCTATCGTAAAT
AGATCATACGATTCGCCGTGCCTA -> GATCATACGATTCGCCGTGCCTAT
AAATTAGGAAAAATACGACTTGTG -> AATTAGGAAAAATACGACTTGTGC
GGCAGAGACATCGGATCCAGTCTG -> GCAGAGACATCGGATCCAGTCTGC
GATACAGCAGCGCCCGACGCACCT -> ATACAGCAGCGCCCGACGCACCTT
AGTCACACTGACCCGTACGTGGTA -> GTCACACTGACCCGTACGTGGTAT
TCTGCCATCTGGGCATTAAGCAGT -> CTGCCATCTGGGCATTAAGCAGTG
GTTTAACTACTCCCCGTTACCCAG -> TTTAACTACTCCCCGTTACCCAGG
CGGTTGCCGAGTAAGCAATCATTC -> GGTTGCCGAGTAAGCAATCATTCA
ACGTAATCATGGCTGAGAAGGACA -> CGTAATCATGGCTGAGAAGGACAC
CCCGGGTGTCTGGCAGATTACTCT -> CCGGGTGTCTGGCAGATTACTCTA
TACGACGTCAAAACGTACCACGGA -> ACGACGTCAAAACGTACCACGGAT
CGAAAGGCCTCTCCCTCATCGGTT -> GAAAGGCCTCTCCCTCATCGGTTG
GAAATCGACTTTCGTTGGATGCTA -> AAATCGACTTTCGTTGGATGCTAG
TCATGGCTGAGAAGGACACTAGAC -> CATGGCTGAGAAGGACACTAGACG
GTATAATCAAAGGTCGGCGGTCCC -> TATAATCAAAGGTCGGCGGTCCCA
ACCCCCATTGCGTTGTATCTTGAA -> CCCCCATTGCGTTGTATCTTGAAC
GCTGAATTAACAGGTCGTATCCCC -> CTGAATTAACAGGTCGTATCCCCA
TCCGGTGTCATACCGTGATTTGAT -> CCGGTGTCATACCGTGATTTGATA
GCCAAATGAATATACACGCTACAG -> CCAAATGAATATACACGCTACAGG
ATAACAGCATTTGTCGGGGAACCC -> TAACAGCATTTGTCGGGGAACCCT
GCTTCGCTTCAGATCATACGATTC -> CTTCGCTTCAGATCATACGATTCG
TCCCTTAAGGCATAGCCGTCGAGC -> CCCTTAAGGCATAGCCGTCGAGCC
TCGAAAATTAGGAAAAATACGACT -> CGAAAATTAGGAAAAATACGACTT
CTCTGCGATCATCCGGTTTAAGTT -> TCTGCGATCATCCGGTTTAAGTTC
CCCCAACACGTGGAAATCGACTTT -> CCCAACACGTGGAAATCGACTTTC
TTGTGGCGCGTAGTAGTAGGTATA -> TGTGGCGCGTAGTAGTAGGTATAA
ATCAAAGGTCGGCGGTCCCAAGGT -> TCAAAGGTCGGCGGTCCCAAGGTC
CCGTGGTTGCTCCCGTCTCCAAGG -> CGTGGTTGCTCCCGTCTCCAAGGC
TATCCTTAAGGTAATTACGACGTC -> ATCCTTAAGGTAATTACGACGTCA
GCCCGGAGGCATAACTTAGTATTC -> CCCGGAGGCATAACTTAGTATTCC
TTGTATCTTGAACCAAAACTGTTA -> TGTATCTTGAACCAAAACTGTTAT
AACGGCTTCGCAGAACCGGGGCGA -> ACGGCTTCGCAGAACCGGGGCGAC
AGTAAAACAAACTATGAATTGTAC -> GTAAAACAAACTATGAATTGTACT
ACTCCCCGTTACCCAGGTGAGAGC -> CTCCCCGTTACCCAGGTGAGAGCA
GGAACTTCAGTCCGGGAGTTCGCG -> GAACTTCAGTCCGGGAGTTCGCGT
ATAACTTAACGACTTGAACGCGCA -> TAACTTAACGACTTGAACGCGCAT
GAGCTCCTGCAGACGCTTCTAGTA -> AGCTCCTGCAGACGCTTCTAGTAA
TTGTAACTCTACGGTCCCGTATAA -> TGTAACTCTACGGTCCCGTATAAT
GAAATATCCGCATCGCAGGAACCC -> AAATATCCGCATCGCAGGAACCCC
ATTTGATACAGCAGCGCCCGACGC -> TTTGATACAGCAGCGCCCGACGCA
AACTACTCCCCGTTACCCAGGTGA -> ACTACTCCCCGTTACCCAGGTGAG
GTTCGCACGACAGGGAACTTCAGT -> TTCGCACGACAGGGAACTTCAGTC
ACGTAGGGAACGCGATTCGTTTTT -> CGTAGGGAACGCGATTCGTTTTTA
TGCAATACGCGTCGCAGCTCAGTC -> GCAATACGCGTCGCAGCTCAGTCG
GGCCTTAGGGAATTGAGTTTGTGG -> GCCTTAGGGAATTGAGTTTGTGGC
AACCAATGGCCTCACGCCAAGCCC -> ACCAATGGCCTCACGCCAAGCCCT
GGTTTAAGTTCGCACGACAGGGAA -> GTTTAAGTTCGCACGACAGGGAAC
GCTAGAGAGAAAGTCACACTGACC -> CTAGAGAGAAAGTCACACTGACCC
CAATGAGTTGTGAGGTACATAGCC -> AATGAGTTGTGAGGTACATAGCCC
CATCACTTCTACATGCCTATTTCG -> ATCACTTCTACATGCCTATTTCGC
TGATCTTAAGTAACATTGAACCAC -> GATCTTAAGTAACATTGAACCACG
AGCTCCCATCTGGCTGCAGGGGGC -> GCTCCCATCTGGCTGCAGGGGGCC
ACACGTAGTCAACATGGTCTACAA -> CACGTAGTCAACATGGTCTACAAA
CTATCGTAAATCTCAGTCGAGGTA -> TATCGTAAATCTCAGTCGAGGTAG
ATTGGACCTGCCCCCTACCGGCCA -> TTGGACCTGCCCCCTACCGGCCAT
TTTGGGGTGGAATTAGGTTATCCA -> TTGGGGTGGAATTAGGTTATCCAG
CAATAACAGCATTTGTCGGGGAAC -> AATAACAGCATTTGTCGGGGAACC
CTGACCCGTACGTGGTATCTCATT -> TGACCCGTACGTGGTATCTCATTG
TGGCAAAACTGCCGGTCATGACCT -> GGCAAAACTGCCGGTCATGACCTG
GCCAAGCCCTTAGTAAAACAAACT -> CCAAGCCCTTAGTAAAACAAACTA
GGGTCAGGTCACGAGCTCCCATCT -> GGTCAGGTCACGAGCTCCCATCTG
AATTAGGTTATCCAGATCTACCCA -> ATTAGGTTATCCAGATCTACCCAG
CCCTCATCGGTTGCGTAAACCGAT -> CCTCATCGGTTGCGTAAACCGATG
AGGCCCAATGGTCCAACAGCCCGC -> GGCCCAATGGTCCAACAGCCCGCC
ATAGCCCCCTCCTTCCCGTGGTTG -> TAGCCCCCTCCTTCCCGTGGTTGC
GCCTCACGCCAAGCCCTTAGTAAA -> CCTCACGCCAAGCCCTTAGTAAAA
GTATCCCCAACACGTGGAAATCGA -> TATCCCCAACACGTGGAAATCGAC
AGAGGTTAGGTTGCGAATTGACGC -> GAGGTTAGGTTGCGAATTGACGCT
TCCATCACTTCTACATGCCTATTT -> CCATCACTTCTACATGCCTATTTC
GGTTGCCGAGTAAGCAATCATTCA -> GTTGCCGAGTAAGCAATCATTCAG
TACGACTTGTGCTATAGTAACACC -> ACGACTTGTGCTATAGTAACACCT
ATTACATGGGTTCGGTTTAACTAC -> TTACATGGGTTCGGTTTAACTACT
GGGAACTTCAGTCCGGGAGTTCGC -> GGAACTTCAGTCCGGGAGTTCGCG
GCCTACACTAGTCCAGAGTAGGTT -> CCTACACTAGTCCAGAGTAGGTTC
CCTCACGCCAAGCCCTTAGTAAAA -> CTCACGCCAAGCCCTTAGTAAAAC
GCAGAACCGGGGCGACCCTGAATG -> CAGAACCGGGGCGACCCTGAATGC
CTACAATCTGCGCCCGGAGGCATA -> TACAATCTGCGCCCGGAGGCATAA
GTGCGAACAAGGCCCAATGGTCCA -> TGCGAACAAGGCCCAATGGTCCAA
ATTGACGCTCCCTTAAGGCATAGC -> TTGACGCTCCCTTAAGGCATAGCC
TATCGTAAATCTCAGTCGAGGTAG -> ATCGTAAATCTCAGTCGAGGTAGT
AAATGAATATACACGCTACAGGAC -> AATGAATATACACGCTACAGGACA
ATTTCGCGTATCCTTAAGGTAATT -> TTTCGCGTATCCTTAAGGTAATTA
ATCCATCACTTCTACATGCCTATT -> TCCATCACTTCTACATGCCTATTT
GTACAAAACTCTCAGTTAAACGGC -> TACAAAACTCTCAGTTAAACGGCT
TCACTTCTACATGCCTATTTCGCG -> CACTTCTACATGCCTATTTCGCGT
AAGTCACACTGACCCGTACGTGGT -> AGTCACACTGACCCGTACGTGGTA
CGCAGGAACCCCTATCGTAAATCT -> GCAGGAACCCCTATCGTAAATCTC
GGGCTACGGCCAACGTAAAACTCC -> GGCTACGGCCAACGTAAAACTCCC
GAGCTCCCATCTGGCTGCAGGGGG -> AGCTCCCATCTGGCTGCAGGGGGC
GTGCAAAGAGAACCAATGGCCTCA -> TGCAAAGAGAACCAATGGCCTCAC
AAACCGATGTGGCCAAGGTACACA -> AACCGATGTGGCCAAGGTACACAC
TTAACGACTTGAACGCGCATTGCT -> TAACGACTTGAACGCGCATTGCTT
GAGAGGATAATCACCTGCCGATCG -> AGAGGATAATCACCTGCCGATCGA
ATCGTAAATCTCAGTCGAGGTAGT -> TCGTAAATCTCAGTCGAGGTAGTT
GTGAGAGCATAGTGAACATATCGT -> TGAGAGCATAGTGAACATATCGTA
GCCAACGTAAAACTCCCCCTGCTT -> CCAACGTAAAACTCCCCCTGCTTC
TTACGATAGTGGCCGTAAGTAACC -> TACGATAGTGGCCGTAAGTAACCG
ACGAGCTCCCATCTGGCTGCAGGG -> CGAGCTCCCATCTGGCTGCAGGGG
CACTAGACGATGGACGGTTGCCGA -> ACTAGACGATGGACGGTTGCCGAG
AGGCCTTAGGGAATTGAGTTTGTG -> GGCCTTAGGGAATTGAGTTTGTGG
GAACAAGGCCCAATGGTCCAACAG -> AACAAGGCCCAATGGTCCAACAGC
AATGCAATACGCGTCGCAGCTCAG -> ATGCAATACGCGTCGCAGCTCAGT
AGGCTCCCGGATTGGCAAAACTGC -> GGCTCCCGGATTGGCAAAACTGCC
TCTCGACTTAGCTGCTTATTGGGT -> CTCGACTTAGCTGCTTATTGGGTG
CGCGAATCGGGTCAGGTCACGAGC -> GCGAATCGGGTCAGGTCACGAGCT
GTACGATGCTACAATCTGCGCCCG -> TACGATGCTACAATCTGCGCCCGG
CCTATACCATCCCATCAGATCGTC -> CTATACCATCCCATCAGATCGTCC
ACTAGCCACCCCCATTGCGTTGTA -> CTAGCCACCCCCATTGCGTTGTAT
TCCGGATTACATGGGTTCGGTTTA -> CCGGATTACATGGGTTCGGTTTAA
GCCCTTAGTAAAACAAACTATGAA -> CCCTTAGTAAAACAAACTATGAAT
GTAAAACTCCCCCTGCTTCGCTTC -> TAAAACTCCCCCTGCTTCGCTTCA
GGAAAAATACGACTTGTGCTATAG -> GAAAAATACGACTTGTGCTATAGT
CCCCTGCTTCGCTTCAGATCATAC -> CCCTGCTTCGCTTCAGATCATACG
GAGTAGGTTCAGAGCAGTACCCAA -> AGTAGGTTCAGAGCAGTACCCAAG
ACGAAAGCCTACACTAGTCCAGAG -> CGAAAGCCTACACTAGTCCAGAGT
AAGTAACCGTCGCAGGAATAGAAA -> AGTAACCGTCGCAGGAATAGAAAT
ATTGCGTTGTATCTTGAACCAAAA -> TTGCGTTGTATCTTGAACCAAAAC
GGAACCCTTCTGGTGATCTTAAGT -> GAACCCTTCTGGTGATCTTAAGTA
CATCTCCTCCGGTGTCATACCGTG -> ATCTCCTCCGGTGTCATACCGTGA
CTAGACGATGGACGGTTGCCGAGT -> TAGACGATGGACGGTTGCCGAGTA
TCCGTATTCCATCAGCGAGCGTGC -> CCGTATTCCATCAGCGAGCGTGCG
CCAAGGTCGAGAGCAATAACAGCA -> CAAGGTCGAGAGCAATAACAGCAT
ACAGGGAACTTCAGTCCGGGAGTT -> CAGGGAACTTCAGTCCGGGAGTTC
CGGATAGGCTCCCGGATTGGCAAA -> GGATAGGCTCCCGGATTGGCAAAA
TAAACGTACTGTGCGACCGTAAAC -> AAACGTACTGTGCGACCGTAAACC
GGATAATCACCTGCCGATCGAAAG -> GATAATCACCTGCCGATCGAAAGG
CCTACCGGCCATCACTATTGCCGC -> CTACCGGCCATCACTATTGCCGCT
CCCCCTGCTTCGCTTCAGATCATA -> CCCCTGCTTCGCTTCAGATCATAC
TAACTGCACGGTGAGGGAAAGCTC -> AACTGCACGGTGAGGGAAAGCTCC
AAGGCCCAATGGTCCAACAGCCCG -> AGGCCCAATGGTCCAACAGCCCGC
TTTGTGGCGCGTAGTAGTAGGTAT -> TTGTGGCGCGTAGTAGTAGGTATA
TTCTCGACTTAGCTGCTTATTGGG -> TCTCGACTTAGCTGCTTATTGGGT
TCAGTCCGGGAGTTCGCGTCAGAG -> CAGTCCGGGAGTTCGCGTCAGAGG
CATTGCGTTGTATCTTGAACCAAA -> ATTGCGTTGTATCTTGAACCAAAA
ATACCGTGATTTGATACAGCAGCG -> TACCGTGATTTGATACAGCAGCGC
AAGCTGCGAGCCACTCCTCTACGC -> AGCTGCGAGCCACTCCTCTACGCC
CTCAGTTAAACGGCTTCGCAGAAC -> TCAGTTAAACGGCTTCGCAGAACC
CATATAGGGCCCATATAATTCTCG -> ATATAGGGCCCATATAATTCTCGA
TACCCAGGTGAGAGCATAGTGAAC -> ACCCAGGTGAGAGCATAGTGAACA
GGTCGGCGGTCCCAAGGTCGAGAG -> GTCGGCGGTCCCAAGGTCGAGAGC
TGACCTGCTATTTGAACTCTCGGG -> GACCTGCTATTTGAACTCTCGGGG
CTGGTGATCTTAAGTAACATTGAA -> TGGTGATCTTAAGTAACATTGAAC
CAACACGTGGAAATCGACTTTCGT -> AACACGTGGAAATCGACTTTCGTT
AGTTGTGAGGTACATAGCCCCCTC -> GTTGTGAGGTACATAGCCCCCTCC
ATTCGCCGTGCCTATACCATCCCA -> TTCGCCGTGCCTATACCATCCCAT
CTGTTATTTGCCTGCCCGGAATGC -> TGTTATTTGCCTGCCCGGAATGCA
ACTCTACGGTCCCGTATAATCAAA -> CTCTACGGTCCCGTATAATCAAAG
CTACAAACTTTCCGTATTCCATCA -> TACAAACTTTCCGTATTCCATCAG
TTGCGTTGTATCTTGAACCAAAAC -> TGCGTTGTATCTTGAACCAAAACT
AGGTACATAGCCCCCTCCTTCCCG -> GGTACATAGCCCCCTCCTTCCCGT
GCCCTCAATGATCTGCCATCTGGG -> CCCTCAATGATCTGCCATCTGGGC
ACTAATTCGGCTACTAAAGACTTG -> CTAATTCGGCTACTAAAGACTTGC
TCCTGCAGACGCTTCTAGTAAACG -> CCTGCAGACGCTTCTAGTAAACGT
TCTCCAAGGCGTGGGAGATCCATC -> CTCCAAGGCGTGGGAGATCCATCA
TTATAGTTCGAAAGTATTGGACCT -> TATAGTTCGAAAGTATTGGACCTG
CCTATTTCGCGTATCCTTAAGGTA -> CTATTTCGCGTATCCTTAAGGTAA
GAGAAATTCTCGCCCACTACGAAA -> AGAAATTCTCGCCCACTACGAAAG
ACACAAGATAGAGTTCATATAGGG -> CACAAGATAGAGTTCATATAGGGC
TGGTGATCTTAAGTAACATTGAAC -> GGTGATCTTAAGTAACATTGAACC
CCTCTCCCTCATCGGTTGCGTAAA -> CTCTCCCTCATCGGTTGCGTAAAC
CATCTGGGCATTAAGCAGTGAAAT -> ATCTGGGCATTAAGCAGTGAAATA
CTCATCGGTTGCGTAAACCGATGT -> TCATCGGTTGCGTAAACCGATGTG
CTTACGTAACTAGCTGGTTTGTAC -> TTACGTAACTAGCTGGTTTGTACT
GTTGCTCCCGTCTCCAAGGCGTGG -> TTGCTCCCGTCTCCAAGGCGTGGG
GGTCCCAAGGTCGAGAGCAATAAC -> GTCCCAAGGTCGAGAGCAATAACA
CGGTGAGGGAAAGCTCCACTGAGC -> GGTGAGGGAAAGCTCCACTGAGCG
CCCCTACCGGCCATCACTATTGCC -> CCCTACCGGCCATCACTATTGCCG
ATAATCAAAGGTCGGCGGTCCCAA -> TAATCAAAGGTCGGCGGTCCCAAG
CACGAGCTCCCATCTGGCTGCAGG -> ACGAGCTCCCATCTGGCTGCAGGG
TTGACGCTCCCTTAAGGCATAGCC -> TGACGCTCCCTTAAGGCATAGCCG
AAAACTGTTATTTGCCTGCCCGGA -> AAACTGTTATTTGCCTGCCCGGAA
TATCCAGATCTACCCAGTTAAGAG -> ATCCAGATCTACCCAGTTAAGAGC
GGATCCAGTCTGCTAACTACGGTG -> GATCCAGTCTGCTAACTACGGTGC
TGGGTCTATTATTTTTTGCTCTAG -> GGGTCTATTATTTTTTGCTCTAGG
GGTCACGAGCTCCCATCTGGCTGC -> GTCACGAGCTCCCATCTGGCTGCA
TGAAATATCCGCATCGCAGGAACC -> GAAATATCCGCATCGCAGGAACCC
GGTGGCTACCGTCAATGAGTTGTG -> GTGGCTACCGTCAATGAGTTGTGA
CTTAGTATTCCGACTTCGCTAGAC -> TTAGTATTCCGACTTCGCTAGACT
GTCAGGTCACGAGCTCCCATCTGG -> TCAGGTCACGAGCTCCCATCTGGC
AACACGTGGAAATCGACTTTCGTT -> ACACGTGGAAATCGACTTTCGTTG
CCGAGGTAGAGAAATTCTCGCCCA -> CGAGGTAGAGAAATTCTCGCCCAC
CCGATCGAAAGGCCTCTCCCTCAT -> CGATCGAAAGGCCTCTCCCTCATC
AAACTCTCAGTTAAACGGCTTCGC -> AACTCTCAGTTAAACGGCTTCGCA
CCTGCCGATCGAAAGGCCTCTCCC -> CTGCCGATCGAAAGGCCTCTCCCT
AGGGAACGCGATTCGTTTTTAACA -> GGGAACGCGATTCGTTTTTAACAC
CTAGAGAGAAAGTCACACTGACCC -> TAGAGAGAAAGTCACACTGACCCG
ATCTCCGCCGCGGGCAGAGACATC -> TCTCCGCCGCGGGCAGAGACATCG
TCTCAGTCGAGGTAGTTACGATAG -> CTCAGTCGAGGTAGTTACGATAGT
CACACTGACCCGTACGTGGTATCT -> ACACTGACCCGTACGTGGTATCTC
TGAACGCGCATTGCTTCCGCGCGA -> GAACGCGCATTGCTTCCGCGCGAA
ATCTGGGCATTAAGCAGTGAAATA -> TCTGGGCATTAAGCAGTGAAATAT
AAGAGCTCCTGCAGACGCTTCTAG -> AGAGCTCCTGCAGACGCTTCTAGT
GCCTATTTCGCGTATCCTTAAGGT -> CCTATTTCGCGTATCCTTAAGGTA
ATCTACCCAGTTAAGAGCTCCTGC -> TCTACCCAGTTAAGAGCTCCTGCA
ACTCTCAGTTAAACGGCTTCGCAG -> CTCTCAGTTAAACGGCTTCGCAGA
GCGCCCGACGCACCTTAGGCCCCG -> CGCCCGACGCACCTTAGGCCCCGT
CGATGTGGCCAAGGTACACACGTA -> GATGTGGCCAAGGTACACACGTAT
ATTTGAACTCTCGGGGAGAATTGT -> TTTGAACTCTCGGGGAGAATTGTA
GACACTAGACGATGGACGGTTGCC -> ACACTAGACGATGGACGGTTGCCG
GGCCAAATGAATATACACGCTACA -> GCCAAATGAATATACACGCTACAG
ACACTAGACGATGGACGGTTGCCG -> CACTAGACGATGGACGGTTGCCGA
AAACAAACTATGAATTGTACTAGC -> AACAAACTATGAATTGTACTAGCC
AGAGCTCCTGCAGACGCTTCTAGT -> GAGCTCCTGCAGACGCTTCTAGTA
CCACTGAGCGCTCTAGCGCAGTGA -> CACTGAGCGCTCTAGCGCAGTGAT
AGGGAAAGCTCCACTGAGCGCTCT -> GGGAAAGCTCCACTGAGCGCTCTA
TGCTAACTGCACGGTGAGGGAAAG -> GCTAACTGCACGGTGAGGGAAAGC
AACCCCTATCGTAAATCTCAGTCG -> ACCCCTATCGTAAATCTCAGTCGA
TACGATTCGCCGTGCCTATACCAT -> ACGATTCGCCGTGCCTATACCATC
AGGGGGCCTAAGCCTGCCGGTACT -> GGGGGCCTAAGCCTGCCGGTACTG
TGCCGATCGAAAGGCCTCTCCCTC -> GCCGATCGAAAGGCCTCTCCCTCA
ACTTTCCGTATTCCATCAGCGAGC -> CTTTCCGTATTCCATCAGCGAGCG
CCGACTTCGCTAGACTTACGTAAC -> CGACTTCGCTAGACTTACGTAACT
ATCTGACGTTATAGTTCGAAAGTA -> TCTGACGTTATAGTTCGAAAGTAT
ATCCCCAACACGTGGAAATCGACT -> TCCCCAACACGTGGAAATCGACTT
TTGGATGCTAGAGAGAAAGTCACA -> TGGATGCTAGAGAGAAAGTCACAC
GGAGGCCTTAGGGAATTGAGTTTG -> GAGGCCTTAGGGAATTGAGTTTGT
GTTTGTGGCGCGTAGTAGTAGGTA -> TTTGTGGCGCGTAGTAGTAGGTAT
TGCGTTGTATCTTGAACCAAAACT -> GCGTTGTATCTTGAACCAAAACTG
TACTAGCCTACAAGTCATCTCCTC -> ACTAGCCTACAAGTCATCTCCTCC
GTCTACAAACTTTCCGTATTCCAT -> TCTACAAACTTTCCGTATTCCATC
TAACGTAATCATGGCTGAGAAGGA -> AACGTAATCATGGCTGAGAAGGAC
TATTCCGACTTCGCTAGACTTACG -> ATTCCGACTTCGCTAGACTTACGT
AGGTAGAGAAATTCTCGCCCACTA -> GGTAGAGAAATTCTCGCCCACTAC
ATTACGACGTCAAAACGTACCACG -> TTACGACGTCAAAACGTACCACGG
GTAATCATGGCTGAGAAGGACACT -> TAATCATGGCTGAGAAGGACACTA
TATTTCGCGTATCCTTAAGGTAAT -> ATTTCGCGTATCCTTAAGGTAATT
AGTAAGCAATCATTCAGAAATCGC -> GTAAGCAATCATTCAGAAATCGCC
ATTAACAGGTCGTATCCCCAACAC -> TTAACAGGTCGTATCCCCAACACG
AGGCCCCGTAGGCGTACAAAACTC -> GGCCCCGTAGGCGTACAAAACTCT
ATGACCTGCTATTTGAACTCTCGG -> TGACCTGCTATTTGAACTCTCGGG
ATGGTCTACAAACTTTCCGTATTC -> TGGTCTACAAACTTTCCGTATTCC
TAAGCCTGCCGGTACTGCACGACG -> AAGCCTGCCGGTACTGCACGACGT
CGCTTCTAGTAAACGTACTGTGCG -> GCTTCTAGTAAACGTACTGTGCGA
TCGCCCACTACGAAAGCCTACACT -> CGCCCACTACGAAAGCCTACACTA
GTGAAATATCCGCATCGCAGGAAC -> TGAAATATCCGCATCGCAGGAACC
TAACACCTGGCACGCCAGACACAA -> AACACCTGGCACGCCAGACACAAG
GAACGCGCATTGCTTCCGCGCGAA -> AACGCGCATTGCTTCCGCGCGAAT
CTAAGCCTGCCGGTACTGCACGAC -> TAAGCCTGCCGGTACTGCACGACG
TTACTCTACCCCGGGCCAAATGAA -> TACTCTACCCCGGGCCAAATGAAT
TCGGCGGTCCCAAGGTCGAGAGCA -> CGGCGGTCCCAAGGTCGAGAGCAA
ATTGCGCTCTGCGATCATCCGGTT -> TTGCGCTCTGCGATCATCCGGTTT
GAGCCAAGCTGCGAGCCACTCCTC -> AGCCAAGCTGCGAGCCACTCCTCT
TACACTAGTCCAGAGTAGGTTCAG -> ACACTAGTCCAGAGTAGGTTCAGA
ACCTTAGGCCCCGTAGGCGTACAA -> CCTTAGGCCCCGTAGGCGTACAAA
TCGGGTCAGGTCACGAGCTCCCAT -> CGGGTCAGGTCACGAGCTCCCATC
TCCTTAAGGTAATTACGACGTCAA -> CCTTAAGGTAATTACGACGTCAAA
CTGCCGGTACTGCACGACGTAGGG -> TGCCGGTACTGCACGACGTAGGGA
TTGCCTGCCCGGAATGCAATACGC -> TGCCTGCCCGGAATGCAATACGCG
CCCCCTAACGTAATCATGGCTGAG -> CCCCTAACGTAATCATGGCTGAGA
CAGTTAAGAGCTCCTGCAGACGCT -> AGTTAAGAGCTCCTGCAGACGCTT
CATTGCGCTCTGCGATCATCCGGT -> ATTGCGCTCTGCGATCATCCGGTT
ACATGCCTATTTCGCGTATCCTTA -> CATGCCTATTTCGCGTATCCTTAA
AGGACACTAGACGATGGACGGTTG -> GGACACTAGACGATGGACGGTTGC
AGTAACACCTGGCACGCCAGACAC -> GTAACACCTGGCACGCCAGACACA
AAAACAAACTATGAATTGTACTAG -> AAACAAACTATGAATTGTACTAGC
TCTGACGTTATAGTTCGAAAGTAT -> CTGACGTTATAGTTCGAAAGTATT
GCATAGCCGTCGAGCCAAGCTGCG -> CATAGCCGTCGAGCCAAGCTGCGA
TCATCTCCTCCGGTGTCATACCGT -> CATCTCCTCCGGTGTCATACCGTG
ACACTAGTCCAGAGTAGGTTCAGA -> CACTAGTCCAGAGTAGGTTCAGAG
TTGCGCTCTGCGATCATCCGGTTT -> TGCGCTCTGCGATCATCCGGTTTA
CGACTTAGCTGCTTATTGGGTGCA -> GACTTAGCTGCTTATTGGGTGCAA
TAGTTCGAAAGTATTGGACCTGCC -> AGTTCGAAAGTATTGGACCTGCCC
TTCGCTAGACTTACGTAACTAGCT -> TCGCTAGACTTACGTAACTAGCTG
CTGAATGCATTATGGGGTACGTGA -> TGAATGCATTATGGGGTACGTGAC
CATCTGGCTGCAGGGGGCCTAAGC -> ATCTGGCTGCAGGGGGCCTAAGCC
TGCTTCCGCGCGAATCGGGTCAGG -> GCTTCCGCGCGAATCGGGTCAGGT
AGTAACCGTCGCAGGAATAGAAAT -> GTAACCGTCGCAGGAATAGAAATG
GGGTAGGCATGGGTTTGGGGTGGA -> GGTAGGCATGGGTTTGGGGTGGAA
AACTTCAGTCCGGGAGTTCGCGTC -> ACTTCAGTCCGGGAGTTCGCGTCA
TTGGGGTGGAATTAGGTTATCCAG -> TGGGGTGGAATTAGGTTATCCAGA
CCACGCTTGTGCTAACTGCACGGT -> CACGCTTGTGCTAACTGCACGGTG
GCTACTAAAGACTTGCTGAATTAA -> CTACTAAAGACTTGCTGAATTAAC
CCGGATTGGCAAAACTGCCGGTCA -> CGGATTGGCAAAACTGCCGGTCAT
AAGGCGTGGGAGATCCATCACTTC -> AGGCGTGGGAGATCCATCACTTCT
ATGATCTGCCATCTGGGCATTAAG -> TGATCTGCCATCTGGGCATTAAGC
ATAAGCGGAGGCCTTAGGGAATTG -> TAAGCGGAGGCCTTAGGGAATTGA
ACCTGCCCCCTACCGGCCATCACT -> CCTGCCCCCTACCGGCCATCACTA
TTCGCCGTGCCTATACCATCCCAT -> TCGCCGTGCCTATACCATCCCATC
AATATCCGCATCGCAGGAACCCCT -> ATATCCGCATCGCAGGAACCCCTA
CGTAAACCTGTCACCTGGCCCGGG -> GTAAACCTGTCACCTGGCCCGGGT
GTTGCGAATTGACGCTCCCTTAAG -> TTGCGAATTGACGCTCCCTTAAGG
ACGCACCTTAGGCCCCGTAGGCGT -> CGCACCTTAGGCCCCGTAGGCGTA
AGCATCGTCGAAAATTAGGAAAAA -> GCATCGTCGAAAATTAGGAAAAAT
TTGTTAGTATCTGTTTGCCGAGGT -> TGTTAGTATCTGTTTGCCGAGGTA
CATTGCTTCCGCGCGAATCGGGTC -> ATTGCTTCCGCGCGAATCGGGTCA
CGCCCGGAGGCATAACTTAGTATT -> GCCCGGAGGCATAACTTAGTATTC
CTCCTGCAGACGCTTCTAGTAAAC -> TCCTGCAGACGCTTCTAGTAAACG
GTAGTTACGATAGTGGCCGTAAGT -> TAGTTACGATAGTGGCCGTAAGTA
TATTGGACCTGCCCCCTACCGGCC -> ATTGGACCTGCCCCCTACCGGCCA
AGCAATAACAGCATTTGTCGGGGA -> GCAATAACAGCATTTGTCGGGGAA
GCGACCGTAAACCTGTCACCTGGC -> CGACCGTAAACCTGTCACCTGGCC
ATCTTAAGTAACATTGAACCACGC -> TCTTAAGTAACATTGAACCACGCT
GGCATAGCCGTCGAGCCAAGCTGC -> GCATAGCCGTCGAGCCAAGCTGCG
CGTGCCTATACCATCCCATCAGAT -> GTGCCTATACCATCCCATCAGATC
CAATCTGCGCCCGGAGGCATAACT -> AATCTGCGCCCGGAGGCATAACTT
GCCAAGGTACACACGTATCTCCGC -> CCAAGGTACACACGTATCTCCGCC
TCATACGATTCGCCGTGCCTATAC -> CATACGATTCGCCGTGCCTATACC
CTGGCTGCAGGGGGCCTAAGCCTG -> TGGCTGCAGGGGGCCTAAGCCTGC
AGAGCAGTACCCAAGCCTAGTGCA -> GAGCAGTACCCAAGCCTAGTGCAA
CGATTCGCCGTGCCTATACCATCC -> GATTCGCCGTGCCTATACCATCCC
ATCGACTTTCGTTGGATGCTAGAG -> TCGACTTTCGTTGGATGCTAGAGA
GGTCAGGTCACGAGCTCCCATCTG -> GTCAGGTCACGAGCTCCCATCTGG
ATAATCACCTGCCGATCGAAAGGC -> TAATCACCTGCCGATCGAAAGGCC
CGTCAGAGGTTAGGTTGCGAATTG -> GTCAGAGGTTAGGTTGCGAATTGA
GCGTTGTATCTTGAACCAAAACTG -> CGTTGTATCTTGAACCAAAACTGT
CGCGCGAATCGGGTCAGGTCACGA -> GCGCGAATCGGGTCAGGTCACGAG
ACGCCAGACACAAGATAGAGTTCA -> CGCCAGACACAAGATAGAGTTCAT
CCGTATAATCAAAGGTCGGCGGTC -> CGTATAATCAAAGGTCGGCGGTCC
TGCGTAAACCGATGTGGCCAAGGT -> GCGTAAACCGATGTGGCCAAGGTA
GCTACAATCTGCGCCCGGAGGCAT -> CTACAATCTGCGCCCGGAGGCATA
CTGCAGACGCTTCTAGTAAACGTA -> TGCAGACGCTTCTAGTAAACGTAC
CCCTTCTGGTGATCTTAAGTAACA -> CCTTCTGGTGATCTTAAGTAACAT
CTGCAGGGGGCCTAAGCCTGCCGG -> TGCAGGGGGCCTAAGCCTGCCGGT
CAGGACATCTACGGTGGTCCGGAT -> AGGACATCTACGGTGGTCCGGATT
GTAGGCGTACAAAACTCTCAGTTA -> TAGGCGTACAAAACTCTCAGTTAA
GAGAGTTGTTAGTATCTGTTTGCC -> AGAGTTGTTAGTATCTGTTTGCCG
ACACTGACCCGTACGTGGTATCTC -> CACTGACCCGTACGTGGTATCTCA
CGTAAGTAACCGTCGCAGGAATAG -> GTAAGTAACCGTCGCAGGAATAGA
TGATCTGCCATCTGGGCATTAAGC -> GATCTGCCATCTGGGCATTAAGCA
CCTGCCCGGAATGCAATACGCGTC -> CTGCCCGGAATGCAATACGCGTCG
TAACTAGCCACCCCCATTGCGTTG -> AACTAGCCACCCCCATTGCGTTGT
GCGTAGTAGTAGGTATAACTTAAC -> CGTAGTAGTAGGTATAACTTAACG
CCTATAAGCGGAGGCCTTAGGGAA -> CTATAAGCGGAGGCCTTAGGGAAT
CCGTAAACCTGTCACCTGGCCCGG -> CGTAAACCTGTCACCTGGCCCGGG
TTGCCGAGGTAGAGAAATTCTCGC -> TGCCGAGGTAGAGAAATTCTCGCC
GGTTAGGTTGCGAATTGACGCTCC -> GTTAGGTTGCGAATTGACGCTCCC
GCACGCCAGACACAAGATAGAGTT -> CACGCCAGACACAAGATAGAGTTC
ATGGTCCAACAGCCCGCCCTCAAT -> TGGTCCAACAGCCCGCCCTCAATG
CTGCACGACGTAGGGAACGCGATT -> TGCACGACGTAGGGAACGCGATTC
CCAAGCCTAGTGCAAAGAGAACCA -> CAAGCCTAGTGCAAAGAGAACCAA
TCGGATCCAGTCTGCTAACTACGG -> CGGATCCAGTCTGCTAACTACGGT
TCTACAAACTTTCCGTATTCCATC -> CTACAAACTTTCCGTATTCCATCA
AGCCGTCGAGCCAAGCTGCGAGCC -> GCCGTCGAGCCAAGCTGCGAGCCA
GAGCAGTACCCAAGCCTAGTGCAA -> AGCAGTACCCAAGCCTAGTGCAAA
CAGTCGCCGGGTAGGCATGGGTTT -> AGTCGCCGGGTAGGCATGGGTTTG
ACCGTGATTTGATACAGCAGCGCC -> CCGTGATTTGATACAGCAGCGCCC
CATGGGTTTGGGGTGGAATTAGGT -> ATGGGTTTGGGGTGGAATTAGGTT
GAGCATCTGACGTTATAGTTCGAA -> AGCATCTGACGTTATAGTTCGAAA
TCGCAGCTCAGTCGCCGGGTAGGC -> CGCAGCTCAGTCGCCGGGTAGGCA
TCGAAAGTATTGGACCTGCCCCCT -> CGAAAGTATTGGACCTGCCCCCTA
CTATTGCCGCTGGAGAGGATAATC -> TATTGCCGCTGGAGAGGATAATCA
TGCTTCGCTTCAGATCATACGATT -> GCTTCGCTTCAGATCATACGATTC
CGCGTAGTAGTAGGTATAACTTAA -> GCGTAGTAGTAGGTATAACTTAAC
TTGCCGCTGGAGAGGATAATCACC -> TGCCGCTGGAGAGGATAATCACCT
CAGTACCCAAGCCTAGTGCAAAGA -> AGTACCCAAGCCTAGTGCAAAGAG
GGCTACGGCCAACGTAAAACTCCC -> GCTACGGCCAACGTAAAACTCCCC
TGGGCTACGGCCAACGTAAAACTC -> GGGCTACGGCCAACGTAAAACTCC
GCCGCTGGAGAGGATAATCACCTG -> CCGCTGGAGAGGATAATCACCTGC
TGCGCTCTGCGATCATCCGGTTTA -> GCGCTCTGCGATCATCCGGTTTAA
TATGGGGTACGTGACTACGTGGGC -> ATGGGGTACGTGACTACGTGGGCT
GATGCTACAATCTGCGCCCGGAGG -> ATGCTACAATCTGCGCCCGGAGGC
ACCGGGGCGACCCTGAATGCATTA -> CCGGGGCGACCCTGAATGCATTAT
GTTTGGGGTGGAATTAGGTTATCC -> TTTGGGGTGGAATTAGGTTATCCA
CACGGGTGGCTACCGTCAATGAGT -> ACGGGTGGCTACCGTCAATGAGTT
GATAATCACCTGCCGATCGAAAGG -> ATAATCACCTGCCGATCGAAAGGC
GCAGCGCCCGACGCACCTTAGGCC -> CAGCGCCCGACGCACCTTAGGCCC
ACCGTCAATGAGTTGTGAGGTACA -> CCGTCAATGAGTTGTGAGGTACAT
GCAGAGACATCGGATCCAGTCTGC -> CAGAGACATCGGATCCAGTCTGCT
TAGTGCAAAGAGAACCAATGGCCT -> AGTGCAAAGAGAACCAATGGCCTC
ATCTTGAACCAAAACTGTTATTTG -> TCTTGAACCAAAACTGTTATTTGC
CAGACGCTTCTAGTAAACGTACTG -> AGACGCTTCTAGTAAACGTACTGT
CATACCGTGATTTGATACAGCAGC -> ATACCGTGATTTGATACAGCAGCG
AAGCATCGTCGAAAATTAGGAAAA -> AGCATCGTCGAAAATTAGGAAAAA
CAGAGGTTAGGTTGCGAATTGACG -> AGAGGTTAGGTTGCGAATTGACGC
TTCGCGTATCCTTAAGGTAATTAC -> TCGCGTATCCTTAAGGTAATTACG
CAGCTCAGTCGCCGGGTAGGCATG -> AGCTCAGTCGCCGGGTAGGCATGG
GCCTAAGCCTGCCGGTACTGCACG -> CCTAAGCCTGCCGGTACTGCACGA
TAGGGAACGCGATTCGTTTTTAAC -> AGGGAACGCGATTCGTTTTTAACA
TTAGTAAAACAAACTATGAATTGT -> TAGTAAAACAAACTATGAATTGTA
CCATCACTATTGCCGCTGGAGAGG -> CATCACTATTGCCGCTGGAGAGGA
CAAGGCCCAATGGTCCAACAGCCC -> AAGGCCCAATGGTCCAACAGCCCG
CGATCATCCGGTTTAAGTTCGCAC -> GATCATCCGGTTTAAGTTCGCACG
CTGCCCCCTACCGGCCATCACTAT -> TGCCCCCTACCGGCCATCACTATT
TACGTGACTACGTGGGCTACGGCC -> ACGTGACTACGTGGGCTACGGCCA
GTAGGTTCAGAGCAGTACCCAAGC -> TAGGTTCAGAGCAGTACCCAAGCC
CTAACTGCACGGTGAGGGAAAGCT -> TAACTGCACGGTGAGGGAAAGCTC
TTATTTTTTGCTCTAGGAGCATCT -> TATTTTTTGCTCTAGGAGCATCTG
GAGCAATAACAGCATTTGTCGGGG -> AGCAATAACAGCATTTGTCGGGGA
TGTCATACCGTGATTTGATACAGC -> GTCATACCGTGATTTGATACAGCA
ACCTGTCACCTGGCCCGGGTGTCT -> CCTGTCACCTGGCCCGGGTGTCTG
AACGCGATTCGTTTTTAACACGTA -> ACGCGATTCGTTTTTAACACGTAG
GAAAGTATTGGACCTGCCCCCTAC -> AAAGTATTGGACCTGCCCCCTACC
CAGGTGAGAGCATAGTGAACATAT -> AGGTGAGAGCATAGTGAACATATC
TTGCTTCCGCGCGAATCGGGTCAG -> TGCTTCCGCGCGAATCGGGTCAGG
TGAATATACACGCTACAGGACATC -> GAATATACACGCTACAGGACATCT
GATAGTGGCCGTAAGTAACCGTCG -> ATAGTGGCCGTAAGTAACCGTCGC
CGCGATTCGTTTTTAACACGTAGT -> GCGATTCGTTTTTAACACGTAGTC
CTACGTGGGCTACGGCCAACGTAA -> TACGTGGGCTACGGCCAACGTAAA
CGTAACTAGCTGGTTTGTACTAAT -> GTAACTAGCTGGTTTGTACTAATT
ACTATGAATTGTACTAGCCTACAA -> CTATGAATTGTACTAGCCTACAAG
CGTTTTTAACACGTAGTCAACATG -> GTTTTTAACACGTAGTCAACATGG
CTAGTAAACGTACTGTGCGACCGT -> TAGTAAACGTACTGTGCGACCGTA
GCGATCATCCGGTTTAAGTTCGCA -> CGATCATCCGGTTTAAGTTCGCAC
GAGGTAGTTACGATAGTGGCCGTA -> AGGTAGTTACGATAGTGGCCGTAA
TGCAAGCACCTATAAGCGGAGGCC -> GCAAGCACCTATAAGCGGAGGCCT
GGTACACACGTATCTCCGCCGCGG -> GTACACACGTATCTCCGCCGCGGG
AAAGGCCTCTCCCTCATCGGTTGC -> AAGGCCTCTCCCTCATCGGTTGCG
ACGATAGTGGCCGTAAGTAACCGT -> CGATAGTGGCCGTAAGTAACCGTC
CAGCGCCCGACGCACCTTAGGCCC -> AGCGCCCGACGCACCTTAGGCCCC
GGTGTCTGGCAGATTACTCTACCC -> GTGTCTGGCAGATTACTCTACCCC
GCGCGAATCGGGTCAGGTCACGAG -> CGCGAATCGGGTCAGGTCACGAGC
TGACGCTCCCTTAAGGCATAGCCG -> GACGCTCCCTTAAGGCATAGCCGT
CCCTTAGTAAAACAAACTATGAAT -> CCTTAGTAAAACAAACTATGAATT
TAAAGACTTGCTGAATTAACAGGT -> AAAGACTTGCTGAATTAACAGGTC
GGTACATAGCCCCCTCCTTCCCGT -> GTACATAGCCCCCTCCTTCCCGTG
TACGATGCTACAATCTGCGCCCGG -> ACGATGCTACAATCTGCGCCCGGA
CGTTGGATGCTAGAGAGAAAGTCA -> GTTGGATGCTAGAGAGAAAGTCAC
TCATCGGTTGCGTAAACCGATGTG -> CATCGGTTGCGTAAACCGATGTGG
CGACCCTGAATGCATTATGGGGTA -> GACCCTGAATGCATTATGGGGTAC
CGGTACTGCACGACGTAGGGAACG -> GGTACTGCACGACGTAGGGAACGC
GAATTAGGTTATCCAGATCTACCC -> AATTAGGTTATCCAGATCTACCCA
TACGAAAGCCTACACTAGTCCAGA -> ACGAAAGCCTACACTAGTCCAGAG
CAGAAATCGCCGGAGGCGTCTGAG -> AGAAATCGCCGGAGGCGTCTGAGA
TCGCCGTGCCTATACCATCCCATC -> CGCCGTGCCTATACCATCCCATCA
TACGTGGGCTACGGCCAACGTAAA -> ACGTGGGCTACGGCCAACGTAAAA
TAAATCTCAGTCGAGGTAGTTACG -> AAATCTCAGTCGAGGTAGTTACGA
GTTCGAAAGTATTGGACCTGCCCC -> TTCGAAAGTATTGGACCTGCCCCC
GTTTGTACTAATTCGGCTACTAAA -> TTTGTACTAATTCGGCTACTAAAG
GGGGTGGAATTAGGTTATCCAGAT -> GGGTGGAATTAGGTTATCCAGATC
TCCAAGGCGTGGGAGATCCATCAC -> CCAAGGCGTGGGAGATCCATCACT
CGGAGGCCTTAGGGAATTGAGTTT -> GGAGGCCTTAGGGAATTGAGTTTG
TTGCCGAGTAAGCAATCATTCAGA -> TGCCGAGTAAGCAATCATTCAGAA
GACGTAGGGAACGCGATTCGTTTT -> ACGTAGGGAACGCGATTCGTTTTT
ACGACAGGGAACTTCAGTCCGGGA -> CGACAGGGAACTTCAGTCCGGGAG
ATCGGGTCAGGTCACGAGCTCCCA -> TCGGGTCAGGTCACGAGCTCCCAT
CGATAGTGGCCGTAAGTAACCGTC -> GATAGTGGCCGTAAGTAACCGTCG
GGGCGACCCTGAATGCATTATGGG -> GGCGACCCTGAATGCATTATGGGG
CTAGTCCAGAGTAGGTTCAGAGCA -> TAGTCCAGAGTAGGTTCAGAGCAG
ACCTGCCGATCGAAAGGCCTCTCC -> CCTGCCGATCGAAAGGCCTCTCCC
CTAGACTTACGTAACTAGCTGGTT -> TAGACTTACGTAACTAGCTGGTTT
CAGGTCACGAGCTCCCATCTGGCT -> AGGTCACGAGCTCCCATCTGGCTG
ACGCTTCTAGTAAACGTACTGTGC -> CGCTTCTAGTAAACGTACTGTGCG
CCAGGTGAGAGCATAGTGAACATA -> CAGGTGAGAGCATAGTGAACATAT
AAAGGTCGGCGGTCCCAAGGTCGA -> AAGGTCGGCGGTCCCAAGGTCGAG
ACCCAGTTAAGAGCTCCTGCAGAC -> CCCAGTTAAGAGCTCCTGCAGACG
GTAACTAGCTGGTTTGTACTAATT -> TAACTAGCTGGTTTGTACTAATTC
GCATTTGTCGGGGAACCCTTCTGG -> CATTTGTCGGGGAACCCTTCTGGT
TGGCCCGGGTGTCTGGCAGATTAC -> GGCCCGGGTGTCTGGCAGATTACT
GAAAGTCACACTGACCCGTACGTG -> AAAGTCACACTGACCCGTACGTGG
GGAATTGAGTTTGTGGCGCGTAGT -> GAATTGAGTTTGTGGCGCGTAGTA
CGGGGAACCCTTCTGGTGATCTTA -> GGGGAACCCTTCTGGTGATCTTAA
ACCAATGGCCTCACGCCAAGCCCT -> CCAATGGCCTCACGCCAAGCCCTT
TCAGTCGCCGGGTAGGCATGGGTT -> CAGTCGCCGGGTAGGCATGGGTTT
GTAGAGAAATTCTCGCCCACTACG -> TAGAGAAATTCTCGCCCACTACGA
TATCCCCAACACGTGGAAATCGAC -> ATCCCCAACACGTGGAAATCGACT
CTTCGCTTCAGATCATACGATTCG -> TTCGCTTCAGATCATACGATTCGC
GTATAACTTAACGACTTGAACGCG -> TATAACTTAACGACTTGAACGCGC
GAGAGCATAGTGAACATATCGTAC -> AGAGCATAGTGAACATATCGTACG
GGGAGTTCGCGTCAGAGGTTAGGT -> GGAGTTCGCGTCAGAGGTTAGGTT
ATTCCATCAGCGAGCGTGCGAACA -> TTCCATCAGCGAGCGTGCGAACAA
ACGGCCAACGTAAAACTCCCCCTG -> CGGCCAACGTAAAACTCCCCCTGC
CACGACAGGGAACTTCAGTCCGGG -> ACGACAGGGAACTTCAGTCCGGGA
GTGACTACGTGGGCTACGGCCAAC -> TGACTACGTGGGCTACGGCCAACG
GCCCATATAATTCTCGACTTAGCT -> CCCATATAATTCTCGACTTAGCTG
GAAAAATACGACTTGTGCTATAGT -> AAAAATACGACTTGTGCTATAGTA
AATGGTCCAACAGCCCGCCCTCAA -> ATGGTCCAACAGCCCGCCCTCAAT
TTCGTTGGATGCTAGAGAGAAAGT -> TCGTTGGATGCTAGAGAGAAAGTC
AATTGTAACTCTACGGTCCCGTAT -> ATTGTAACTCTACGGTCCCGTATA
AGCAATCATTCAGAAATCGCCGGA -> GCAATCATTCAGAAATCGCCGGAG
AGCGCAGTGATAACTAGCCACCCC -> GCGCAGTGATAACTAGCCACCCCC
TTGTGCTAACTGCACGGTGAGGGA -> TGTGCTAACTGCACGGTGAGGGAA
ATGGGTTTGGGGTGGAATTAGGTT -> TGGGTTTGGGGTGGAATTAGGTTA
ATTGTACTAGCCTACAAGTCATCT -> TTGTACTAGCCTACAAGTCATCTC
AAACGTACCACGGATAGGCTCCCG -> AACGTACCACGGATAGGCTCCCGG
ACTACGTGGGCTACGGCCAACGTA -> CTACGTGGGCTACGGCCAACGTAA
ATCCGCATCGCAGGAACCCCTATC -> TCCGCATCGCAGGAACCCCTATCG
CCGTCAATGAGTTGTGAGGTACAT -> CGTCAATGAGTTGTGAGGTACATA
GGTAGTTACGATAGTGGCCGTAAG -> GTAGTTACGATAGTGGCCGTAAGT
GAATGCATTATGGGGTACGTGACT -> AATGCATTATGGGGTACGTGACTA
ATTGTAACTCTACGGTCCCGTATA -> TTGTAACTCTACGGTCCCGTATAA
CCCGTGGTTGCTCCCGTCTCCAAG -> CCGTGGTTGCTCCCGTCTCCAAGG
CGATCGAAAGGCCTCTCCCTCATC -> GATCGAAAGGCCTCTCCCTCATCG
TCGCCGGGTAGGCATGGGTTTGGG -> CGCCGGGTAGGCATGGGTTTGGGG
GGCCATCACTATTGCCGCTGGAGA -> GCCATCACTATTGCCGCTGGAGAG
TCTACGGTGGTCCGGATTACATGG -> CTACGGTGGTCCGGATTACATGGG
TTGAACGCGCATTGCTTCCGCGCG -> TGAACGCGCATTGCTTCCGCGCGA
AAGTATTGGACCTGCCCCCTACCG -> AGTATTGGACCTGCCCCCTACCGG
GCAATAACAGCATTTGTCGGGGAA -> CAATAACAGCATTTGTCGGGGAAC
AACTAGCCACCCCCATTGCGTTGT -> ACTAGCCACCCCCATTGCGTTGTA
TACCCCGGGCCAAATGAATATACA -> ACCCCGGGCCAAATGAATATACAC
ACGACGTCAAAACGTACCACGGAT -> CGACGTCAAAACGTACCACGGATA
TCTAGGAGCATCTGACGTTATAGT -> CTAGGAGCATCTGACGTTATAGTT
GAACCCTTCTGGTGATCTTAAGTA -> AACCCTTCTGGTGATCTTAAGTAA
ACTTAACGACTTGAACGCGCATTG -> CTTAACGACTTGAACGCGCATTGC
CCCTATCGTAAATCTCAGTCGAGG -> CCTATCGTAAATCTCAGTCGAGGT
CTATAAGCGGAGGCCTTAGGGAAT -> TATAAGCGGAGGCCTTAGGGAATT
ATGCCTATTTCGCGTATCCTTAAG -> TGCCTATTTCGCGTATCCTTAAGG
CAAGCACCTATAAGCGGAGGCCTT -> AAGCACCTATAAGCGGAGGCCTTA
AACTGTTATTTGCCTGCCCGGAAT -> ACTGTTATTTGCCTGCCCGGAATG
AAGCCCTTAGTAAAACAAACTATG -> AGCCCTTAGTAAAACAAACTATGA
GCGACCCTGAATGCATTATGGGGT -> CGACCCTGAATGCATTATGGGGTA
GAATCGGGTCAGGTCACGAGCTCC -> AATCGGGTCAGGTCACGAGCTCCC
ACTACTCCCCGTTACCCAGGTGAG -> CTACTCCCCGTTACCCAGGTGAGA
ACTTCTACATGCCTATTTCGCGTA -> CTTCTACATGCCTATTTCGCGTAT
CGTACGTGGTATCTCATTGCGCTC -> GTACGTGGTATCTCATTGCGCTCT
GACTTGCTGAATTAACAGGTCGTA -> ACTTGCTGAATTAACAGGTCGTAT
CCTGGCCCGGGTGTCTGGCAGATT -> CTGGCCCGGGTGTCTGGCAGATTA
ACAATCTGCGCCCGGAGGCATAAC -> CAATCTGCGCCCGGAGGCATAACT
CCTTCTGGTGATCTTAAGTAACAT -> CTTCTGGTGATCTTAAGTAACATT
CATCGGTTGCGTAAACCGATGTGG -> ATCGGTTGCGTAAACCGATGTGGC
CGACTTTCGTTGGATGCTAGAGAG -> GACTTTCGTTGGATGCTAGAGAGA
CATCCCATCAGATCGTCCCACGGG -> ATCCCATCAGATCGTCCCACGGGT
CCCGCCCTCAATGATCTGCCATCT -> CCGCCCTCAATGATCTGCCATCTG
CTACTAAAGACTTGCTGAATTAAC -> TACTAAAGACTTGCTGAATTAACA
TTAACAGGTCGTATCCCCAACACG -> TAACAGGTCGTATCCCCAACACGT
GGGCCTAAGCCTGCCGGTACTGCA -> GGCCTAAGCCTGCCGGTACTGCAC
CACCTGCCGATCGAAAGGCCTCTC -> ACCTGCCGATCGAAAGGCCTCTCC
GTACGTGGTATCTCATTGCGCTCT -> TACGTGGTATCTCATTGCGCTCTG
CTGTTTGCCGAGGTAGAGAAATTC -> TGTTTGCCGAGGTAGAGAAATTCT
CAAGGTACACACGTATCTCCGCCG -> AAGGTACACACGTATCTCCGCCGC
TCGTATCCCCAACACGTGGAAATC -> CGTATCCCCAACACGTGGAAATCG
CTCCACTGAGCGCTCTAGCGCAGT -> TCCACTGAGCGCTCTAGCGCAGTG
ATTCTCGCCCACTACGAAAGCCTA -> TTCTCGCCCACTACGAAAGCCTAC
CATGGCTGAGAAGGACACTAGACG -> ATGGCTGAGAAGGACACTAGACGA
CTACGGTGCTATCCCCCTAACGTA -> TACGGTGCTATCCCCCTAACGTAA
GAGGCGTCTGAGAGTTGTTAGTAT -> AGGCGTCTGAGAGTTGTTAGTATC
CCTGCCGGTACTGCACGACGTAGG -> CTGCCGGTACTGCACGACGTAGGG
GCGAATTGACGCTCCCTTAAGGCA -> CGAATTGACGCTCCCTTAAGGCAT
AAGGTACACACGTATCTCCGCCGC -> AGGTACACACGTATCTCCGCCGCG
GCCCGACGCACCTTAGGCCCCGTA -> CCCGACGCACCTTAGGCCCCGTAG
AGCCAAGCTGCGAGCCACTCCTCT -> GCCAAGCTGCGAGCCACTCCTCTA
GCCATCTGGGCATTAAGCAGTGAA -> CCATCTGGGCATTAAGCAGTGAAA
TGCCCCCTACCGGCCATCACTATT -> GCCCCCTACCGGCCATCACTATTG
CAAACTTTCCGTATTCCATCAGCG -> AAACTTTCCGTATTCCATCAGCGA
TATCGTACGATGCTACAATCTGCG -> ATCGTACGATGCTACAATCTGCGC
TTAGGCCCCGTAGGCGTACAAAAC -> TAGGCCCCGTAGGCGTACAAAACT
CTAGCCACCCCCATTGCGTTGTAT -> TAGCCACCCCCATTGCGTTGTATC
ATGGGGTACGTGACTACGTGGGCT -> TGGGGTACGTGACTACGTGGGCTA
GGCTCCCGGATTGGCAAAACTGCC -> GCTCCCGGATTGGCAAAACTGCCG
CGGCTTCGCAGAACCGGGGCGACC -> GGCTTCGCAGAACCGGGGCGACCC
TAAACCGATGTGGCCAAGGTACAC -> AAACCGATGTGGCCAAGGTACACA
TGACTACGTGGGCTACGGCCAACG -> GACTACGTGGGCTACGGCCAACGT
TCCATCAGCGAGCGTGCGAACAAG -> CCATCAGCGAGCGTGCGAACAAGG
CAAAACTCTCAGTTAAACGGCTTC -> AAAACTCTCAGTTAAACGGCTTCG
ACGATGCTACAATCTGCGCCCGGA -> CGATGCTACAATCTGCGCCCGGAG
CGGGGCGACCCTGAATGCATTATG -> GGGGCGACCCTGAATGCATTATGG
GGGGGCCTAAGCCTGCCGGTACTG -> GGGGCCTAAGCCTGCCGGTACTGC
AAAACTCTCAGTTAAACGGCTTCG -> AAACTCTCAGTTAAACGGCTTCGC
AACCGTCGCAGGAATAGAAATGGG -> ACCGTCGCAGGAATAGAAATGGGT
CGTATTCCATCAGCGAGCGTGCGA -> GTATTCCATCAGCGAGCGTGCGAA
GACGCACCTTAGGCCCCGTAGGCG -> ACGCACCTTAGGCCCCGTAGGCGT
GCTATCCCCCTAACGTAATCATGG -> CTATCCCCCTAACGTAATCATGGC
GCCTATACCATCCCATCAGATCGT -> CCTATACCATCCCATCAGATCGTC
CTTCTAGTAAACGTACTGTGCGAC -> TTCTAGTAAACGTACTGTGCGACC
TGCCTATACCATCCCATCAGATCG -> GCCTATACCATCCCATCAGATCGT
CCAACACGTGGAAATCGACTTTCG -> CAACACGTGGAAATCGACTTTCGT
AGACGATGGACGGTTGCCGAGTAA -> GACGATGGACGGTTGCCGAGTAAG
TTAGTATCTGTTTGCCGAGGTAGA -> TAGTATCTGTTTGCCGAGGTAGAG
CTACCGTCAATGAGTTGTGAGGTA -> TACCGTCAATGAGTTGTGAGGTAC
TACCGTGATTTGATACAGCAGCGC -> ACCGTGATTTGATACAGCAGCGCC
TTCAGATCATACGATTCGCCGTGC -> TCAGATCATACGATTCGCCGTGCC
ATCCAGTCTGCTAACTACGGTGCT -> TCCAGTCTGCTAACTACGGTGCTA
TGCGATCATCCGGTTTAAGTTCGC -> GCGATCATCCGGTTTAAGTTCGCA
GTATTCCATCAGCGAGCGTGCGAA -> TATTCCATCAGCGAGCGTGCGAAC
AACTCTCAGTTAAACGGCTTCGCA -> ACTCTCAGTTAAACGGCTTCGCAG
CGCTACAGGACATCTACGGTGGTC -> GCTACAGGACATCTACGGTGGTCC
GTTCATATAGGGCCCATATAATTC -> TTCATATAGGGCCCATATAATTCT
GCTGAGAAGGACACTAGACGATGG -> CTGAGAAGGACACTAGACGATGGA
TCAGAAATCGCCGGAGGCGTCTGA -> CAGAAATCGCCGGAGGCGTCTGAG
GCTCAGTCGCCGGGTAGGCATGGG -> CTCAGTCGCCGGGTAGGCATGGGT
TTTGTACTAATTCGGCTACTAAAG -> TTGTACTAATTCGGCTACTAAAGA
AGGTCACGAGCTCCCATCTGGCTG -> GGTCACGAGCTCCCATCTGGCTGC
GGTGATCTTAAGTAACATTGAACC -> GTGATCTTAAGTAACATTGAACCA
GTTTGCCGAGGTAGAGAAATTCTC -> TTTGCCGAGGTAGAGAAATTCTCG
CCCTCCTTCCCGTGGTTGCTCCCG -> CCTCCTTCCCGTGGTTGCTCCCGT
CAGAGCAGTACCCAAGCCTAGTGC -> AGAGCAGTACCCAAGCCTAGTGCA
AGGTACACACGTATCTCCGCCGCG -> GGTACACACGTATCTCCGCCGCGG
CATTATGGGGTACGTGACTACGTG -> ATTATGGGGTACGTGACTACGTGG
TTTAAGTTCGCACGACAGGGAACT -> TTAAGTTCGCACGACAGGGAACTT
GCAGTGATAACTAGCCACCCCCAT -> CAGTGATAACTAGCCACCCCCATT
GACGTTATAGTTCGAAAGTATTGG -> ACGTTATAGTTCGAAAGTATTGGA
TAACTCTACGGTCCCGTATAATCA -> AACTCTACGGTCCCGTATAATCAA
CCGACGCACCTTAGGCCCCGTAGG -> CGACGCACCTTAGGCCCCGTAGGC
TTCAGAAATCGCCGGAGGCGTCTG -> TCAGAAATCGCCGGAGGCGTCTGA
CGATTCGTTTTTAACACGTAGTCA -> GATTCGTTTTTAACACGTAGTCAA
GGTGGAATTAGGTTATCCAGATCT -> GTGGAATTAGGTTATCCAGATCTA
GCCCCCTCCTTCCCGTGGTTGCTC -> CCCCCTCCTTCCCGTGGTTGCTCC
CACACGTATCTCCGCCGCGGGCAG -> ACACGTATCTCCGCCGCGGGCAGA
TTAACTACTCCCCGTTACCCAGGT -> TAACTACTCCCCGTTACCCAGGTG
AACCCTTCTGGTGATCTTAAGTAA -> ACCCTTCTGGTGATCTTAAGTAAC
TGGATGCTAGAGAGAAAGTCACAC -> GGATGCTAGAGAGAAAGTCACACT
GGATTGGCAAAACTGCCGGTCATG -> GATTGGCAAAACTGCCGGTCATGA
GAACCAAAACTGTTATTTGCCTGC -> AACCAAAACTGTTATTTGCCTGCC
AAGGTCGGCGGTCCCAAGGTCGAG -> AGGTCGGCGGTCCCAAGGTCGAGA
TCTGGGCATTAAGCAGTGAAATAT -> CTGGGCATTAAGCAGTGAAATATC
CTAGGAGCATCTGACGTTATAGTT -> TAGGAGCATCTGACGTTATAGTTC
TACATAGCCCCCTCCTTCCCGTGG -> ACATAGCCCCCTCCTTCCCGTGGT
CGCTAGACTTACGTAACTAGCTGG -> GCTAGACTTACGTAACTAGCTGGT
TGGGTTCGGTTTAACTACTCCCCG -> GGGTTCGGTTTAACTACTCCCCGT
TCGCACGACAGGGAACTTCAGTCC -> CGCACGACAGGGAACTTCAGTCCG
ACAAACTTTCCGTATTCCATCAGC -> CAAACTTTCCGTATTCCATCAGCG
GTGCGACCGTAAACCTGTCACCTG -> TGCGACCGTAAACCTGTCACCTGG
GGAAATCGACTTTCGTTGGATGCT -> GAAATCGACTTTCGTTGGATGCTA
CACGCCAGACACAAGATAGAGTTC -> ACGCCAGACACAAGATAGAGTTCA
CCGATGTGGCCAAGGTACACACGT -> CGATGTGGCCAAGGTACACACGTA
AACCGGGGCGACCCTGAATGCATT -> ACCGGGGCGACCCTGAATGCATTA
ACCGGCCATCACTATTGCCGCTGG -> CCGGCCATCACTATTGCCGCTGGA
TCGCGTATCCTTAAGGTAATTACG -> CGCGTATCCTTAAGGTAATTACGA
AAGCGGAGGCCTTAGGGAATTGAG -> AGCGGAGGCCTTAGGGAATTGAGT
CGACGTCAAAACGTACCACGGATA -> GACGTCAAAACGTACCACGGATAG
CCGCGGGCAGAGACATCGGATCCA -> CGCGGGCAGAGACATCGGATCCAG
TGCCCGGAATGCAATACGCGTCGC -> GCCCGGAATGCAATACGCGTCGCA
GCCAGACACAAGATAGAGTTCATA -> CCAGACACAAGATAGAGTTCATAT
AAAGACTTGCTGAATTAACAGGTC -> AAGACTTGCTGAATTAACAGGTCG
CGGGTCAGGTCACGAGCTCCCATC -> GGGTCAGGTCACGAGCTCCCATCT
GGCCCAATGGTCCAACAGCCCGCC -> GCCCAATGGTCCAACAGCCCGCCC
CGCATTGCTTCCGCGCGAATCGGG -> GCATTGCTTCCGCGCGAATCGGGT
TGCCGAGGTAGAGAAATTCTCGCC -> GCCGAGGTAGAGAAATTCTCGCCC
ACGCTACAGGACATCTACGGTGGT -> CGCTACAGGACATCTACGGTGGTC
TCAGAGCAGTACCCAAGCCTAGTG -> CAGAGCAGTACCCAAGCCTAGTGC
CGAAAGTATTGGACCTGCCCCCTA -> GAAAGTATTGGACCTGCCCCCTAC
CACGTATCTCCGCCGCGGGCAGAG -> ACGTATCTCCGCCGCGGGCAGAGA
GCACGGTGAGGGAAAGCTCCACTG -> CACGGTGAGGGAAAGCTCCACTGA
TGCCGGTACTGCACGACGTAGGGA -> GCCGGTACTGCACGACGTAGGGAA
GGGGAGAATTGTAACTCTACGGTC -> GGGAGAATTGTAACTCTACGGTCC
TCTGGCAGATTACTCTACCCCGGG -> CTGGCAGATTACTCTACCCCGGGC
CGTTACCCAGGTGAGAGCATAGTG -> GTTACCCAGGTGAGAGCATAGTGA
AAGTTCGCACGACAGGGAACTTCA -> AGTTCGCACGACAGGGAACTTCAG
GATTTGATACAGCAGCGCCCGACG -> ATTTGATACAGCAGCGCCCGACGC
GGTCATGACCTGCTATTTGAACTC -> GTCATGACCTGCTATTTGAACTCT
TGGTCCAACAGCCCGCCCTCAATG -> GGTCCAACAGCCCGCCCTCAATGA
CATAGTGAACATATCGTACGATGC -> ATAGTGAACATATCGTACGATGCT
TAAAACAAACTATGAATTGTACTA -> AAAACAAACTATGAATTGTACTAG
GTTATCCAGATCTACCCAGTTAAG -> TTATCCAGATCTACCCAGTTAAGA
TGCTACAATCTGCGCCCGGAGGCA -> GCTACAATCTGCGCCCGGAGGCAT
TAAGTTCGCACGACAGGGAACTTC -> AAGTTCGCACGACAGGGAACTTCA
GTTATTTGCCTGCCCGGAATGCAA -> TTATTTGCCTGCCCGGAATGCAAT
CTGAGAAGGACACTAGACGATGGA -> TGAGAAGGACACTAGACGATGGAC
ACGTGGGCTACGGCCAACGTAAAA -> CGTGGGCTACGGCCAACGTAAAAC
CCGTCTCCAAGGCGTGGGAGATCC -> CGTCTCCAAGGCGTGGGAGATCCA
TACCCAAGCCTAGTGCAAAGAGAA -> ACCCAAGCCTAGTGCAAAGAGAAC
ACGTAAAACTCCCCCTGCTTCGCT -> CGTAAAACTCCCCCTGCTTCGCTT
GTCCAACAGCCCGCCCTCAATGAT -> TCCAACAGCCCGCCCTCAATGATC
GGTAATTACGACGTCAAAACGTAC -> GTAATTACGACGTCAAAACGTACC
GGCTTCGCAGAACCGGGGCGACCC -> GCTTCGCAGAACCGGGGCGACCCT
CTATGAATTGTACTAGCCTACAAG -> TATGAATTGTACTAGCCTACAAGT
TCGTTGGATGCTAGAGAGAAAGTC -> CGTTGGATGCTAGAGAGAAAGTCA
GGGGAACCCTTCTGGTGATCTTAA -> GGGAACCCTTCTGGTGATCTTAAG
ATAGTTCGAAAGTATTGGACCTGC -> TAGTTCGAAAGTATTGGACCTGCC
TGCATTATGGGGTACGTGACTACG -> GCATTATGGGGTACGTGACTACGT
TTTTGCTCTAGGAGCATCTGACGT -> TTTGCTCTAGGAGCATCTGACGTT
TCACGAGCTCCCATCTGGCTGCAG -> CACGAGCTCCCATCTGGCTGCAGG
GACTTACGTAACTAGCTGGTTTGT -> ACTTACGTAACTAGCTGGTTTGTA
GGGTGTCTGGCAGATTACTCTACC -> GGTGTCTGGCAGATTACTCTACCC
CGTATCCTTAAGGTAATTACGACG -> GTATCCTTAAGGTAATTACGACGT
ACCCCGGGCCAAATGAATATACAC -> CCCCGGGCCAAATGAATATACACG
TTGCTCCCGTCTCCAAGGCGTGGG -> TGCTCCCGTCTCCAAGGCGTGGGA
GGTCGAGAGCAATAACAGCATTTG -> GTCGAGAGCAATAACAGCATTTGT
CTGCCGGTCATGACCTGCTATTTG -> TGCCGGTCATGACCTGCTATTTGA
GGCGTCTGAGAGTTGTTAGTATCT -> GCGTCTGAGAGTTGTTAGTATCTG
TAAGAGCTCCTGCAGACGCTTCTA -> AAGAGCTCCTGCAGACGCTTCTAG
AGCCCTTAGTAAAACAAACTATGA -> GCCCTTAGTAAAACAAACTATGAA
AGAAATTCTCGCCCACTACGAAAG -> GAAATTCTCGCCCACTACGAAAGC
CCAAGCTGCGAGCCACTCCTCTAC -> CAAGCTGCGAGCCACTCCTCTACG
TTGGCAAAACTGCCGGTCATGACC -> TGGCAAAACTGCCGGTCATGACCT
ATCTGCGCCCGGAGGCATAACTTA -> TCTGCGCCCGGAGGCATAACTTAG
TGGAAATCGACTTTCGTTGGATGC -> GGAAATCGACTTTCGTTGGATGCT
GGAACCCCTATCGTAAATCTCAGT -> GAACCCCTATCGTAAATCTCAGTC
ACGGTGCTATCCCCCTAACGTAAT -> CGGTGCTATCCCCCTAACGTAATC
GTTAAACGGCTTCGCAGAACCGGG -> TTAAACGGCTTCGCAGAACCGGGG
CTACGGTGGTCCGGATTACATGGG -> TACGGTGGTCCGGATTACATGGGT
GGCATTAAGCAGTGAAATATCCGC -> GCATTAAGCAGTGAAATATCCGCA
CACCTGGCACGCCAGACACAAGAT -> ACCTGGCACGCCAGACACAAGATA
CAGCATTTGTCGGGGAACCCTTCT -> AGCATTTGTCGGGGAACCCTTCTG
ATCTGTTTGCCGAGGTAGAGAAAT -> TCTGTTTGCCGAGGTAGAGAAATT
GAATAGAAATGGGTCTATTATTTT -> AATAGAAATGGGTCTATTATTTTT
AAGGTCGAGAGCAATAACAGCATT -> AGGTCGAGAGCAATAACAGCATTT
GCTAACTACGGTGCTATCCCCCTA -> CTAACTACGGTGCTATCCCCCTAA
ACGTACTGTGCGACCGTAAACCTG -> CGTACTGTGCGACCGTAAACCTGT
GCTATAGTAACACCTGGCACGCCA -> CTATAGTAACACCTGGCACGCCAG
GAATTGACGCTCCCTTAAGGCATA -> AATTGACGCTCCCTTAAGGCATAG
GTAGTAGGTATAACTTAACGACTT -> TAGTAGGTATAACTTAACGACTTG
AATACGACTTGTGCTATAGTAACA -> ATACGACTTGTGCTATAGTAACAC
GTACCACGGATAGGCTCCCGGATT -> TACCACGGATAGGCTCCCGGATTG
AGGTTAGGTTGCGAATTGACGCTC -> GGTTAGGTTGCGAATTGACGCTCC
CCGGGAGTTCGCGTCAGAGGTTAG -> CGGGAGTTCGCGTCAGAGGTTAGG
AGGAATAGAAATGGGTCTATTATT -> GGAATAGAAATGGGTCTATTATTT
CGTAGTCAACATGGTCTACAAACT -> GTAGTCAACATGGTCTACAAACTT
ATAACTAGCCACCCCCATTGCGTT -> TAACTAGCCACCCCCATTGCGTTG
ATCCCATCAGATCGTCCCACGGGT -> TCCCATCAGATCGTCCCACGGGTG
ATTTGCCTGCCCGGAATGCAATAC -> TTTGCCTGCCCGGAATGCAATACG
ATACGCGTCGCAGCTCAGTCGCCG -> TACGCGTCGCAGCTCAGTCGCCGG
GATCTACCCAGTTAAGAGCTCCTG -> ATCTACCCAGTTAAGAGCTCCTGC
GACAGGGAACTTCAGTCCGGGAGT -> ACAGGGAACTTCAGTCCGGGAGTT
AATTAGGAAAAATACGACTTGTGC -> ATTAGGAAAAATACGACTTGTGCT
ACTACGGTGCTATCCCCCTAACGT -> CTACGGTGCTATCCCCCTAACGTA
TTACGACGTCAAAACGTACCACGG -> TACGACGTCAAAACGTACCACGGA
GTCGAGGTAGTTACGATAGTGGCC -> TCGAGGTAGTTACGATAGTGGCCG
GTCATACCGTGATTTGATACAGCA -> TCATACCGTGATTTGATACAGCAG
CCCCTCCTTCCCGTGGTTGCTCCC -> CCCTCCTTCCCGTGGTTGCTCCCG
ACACACGTATCTCCGCCGCGGGCA -> CACACGTATCTCCGCCGCGGGCAG
TACCGGCCATCACTATTGCCGCTG -> ACCGGCCATCACTATTGCCGCTGG
CGAATTGACGCTCCCTTAAGGCAT -> GAATTGACGCTCCCTTAAGGCATA
GTTCGCGTCAGAGGTTAGGTTGCG -> TTCGCGTCAGAGGTTAGGTTGCGA
AATTGTACTAGCCTACAAGTCATC -> ATTGTACTAGCCTACAAGTCATCT
AATCGGGTCAGGTCACGAGCTCCC -> ATCGGGTCAGGTCACGAGCTCCCA
GCCCGGGTGTCTGGCAGATTACTC -> CCCGGGTGTCTGGCAGATTACTCT
TACCACGGATAGGCTCCCGGATTG -> ACCACGGATAGGCTCCCGGATTGG
GTAAAACAAACTATGAATTGTACT -> TAAAACAAACTATGAATTGTACTA
TATACACGCTACAGGACATCTACG -> ATACACGCTACAGGACATCTACGG
TGTGCTATAGTAACACCTGGCACG -> GTGCTATAGTAACACCTGGCACGC
GGCGGTCCCAAGGTCGAGAGCAAT -> GCGGTCCCAAGGTCGAGAGCAATA
AACTCTCGGGGAGAATTGTAACTC -> ACTCTCGGGGAGAATTGTAACTCT
AGTTACGATAGTGGCCGTAAGTAA -> GTTACGATAGTGGCCGTAAGTAAC
AGGAGCATCTGACGTTATAGTTCG -> GGAGCATCTGACGTTATAGTTCGA
CCCAAGCCTAGTGCAAAGAGAACC -> CCAAGCCTAGTGCAAAGAGAACCA
GCAAGCACCTATAAGCGGAGGCCT -> CAAGCACCTATAAGCGGAGGCCTT
GTGGTCCGGATTACATGGGTTCGG -> TGGTCCGGATTACATGGGTTCGGT
TGTCACCTGGCCCGGGTGTCTGGC -> GTCACCTGGCCCGGGTGTCTGGCA
GTGGTATCTCATTGCGCTCTGCGA -> TGGTATCTCATTGCGCTCTGCGAT
ATAGGGCCCATATAATTCTCGACT -> TAGGGCCCATATAATTCTCGACTT
GTACATAGCCCCCTCCTTCCCGTG -> TACATAGCCCCCTCCTTCCCGTGG
GCTCCCGTCTCCAAGGCGTGGGAG -> CTCCCGTCTCCAAGGCGTGGGAGA
CGGTGTCATACCGTGATTTGATAC -> GGTGTCATACCGTGATTTGATACA
CAGGGAACTTCAGTCCGGGAGTTC -> AGGGAACTTCAGTCCGGGAGTTCG
AGAAAGTCACACTGACCCGTACGT -> GAAAGTCACACTGACCCGTACGTG
ACTCTACCCCGGGCCAAATGAATA -> CTCTACCCCGGGCCAAATGAATAT
CTTCCCGTGGTTGCTCCCGTCTCC -> TTCCCGTGGTTGCTCCCGTCTCCA
TTTCGCGTATCCTTAAGGTAATTA -> TTCGCGTATCCTTAAGGTAATTAC
AGTTCATATAGGGCCCATATAATT -> GTTCATATAGGGCCCATATAATTC
TAGAGAGAAAGTCACACTGACCCG -> AGAGAGAAAGTCACACTGACCCGT
AAGAGAACCAATGGCCTCACGCCA -> AGAGAACCAATGGCCTCACGCCAA
CCGTACGTGGTATCTCATTGCGCT -> CGTACGTGGTATCTCATTGCGCTC
TACGGCCAACGTAAAACTCCCCCT -> ACGGCCAACGTAAAACTCCCCCTG
CCGTAGGCGTACAAAACTCTCAGT -> CGTAGGCGTACAAAACTCTCAGTT
GCCCGCCCTCAATGATCTGCCATC -> CCCGCCCTCAATGATCTGCCATCT
CAGTCCGGGAGTTCGCGTCAGAGG -> AGTCCGGGAGTTCGCGTCAGAGGT
ATTGAGTTTGTGGCGCGTAGTAGT -> TTGAGTTTGTGGCGCGTAGTAGTA
CCAAGGCGTGGGAGATCCATCACT -> CAAGGCGTGGGAGATCCATCACTT
TAGGCATGGGTTTGGGGTGGAATT -> AGGCATGGGTTTGGGGTGGAATTA
ATTCTCGACTTAGCTGCTTATTGG -> TTCTCGACTTAGCTGCTTATTGGG
CGGTTGCGTAAACCGATGTGGCCA -> GGTTGCGTAAACCGATGTGGCCAA
CCATTGCGTTGTATCTTGAACCAA -> CATTGCGTTGTATCTTGAACCAAA
CAAAGAGAACCAATGGCCTCACGC -> AAAGAGAACCAATGGCCTCACGCC
GTGATTTGATACAGCAGCGCCCGA -> TGATTTGATACAGCAGCGCCCGAC
CCCCTATCGTAAATCTCAGTCGAG -> CCCTATCGTAAATCTCAGTCGAGG
TAGTAAAACAAACTATGAATTGTA -> AGTAAAACAAACTATGAATTGTAC
GTTTTTAACACGTAGTCAACATGG -> TTTTTAACACGTAGTCAACATGGT
GTACTGTGCGACCGTAAACCTGTC -> TACTGTGCGACCGTAAACCTGTCA
GTCGGCGGTCCCAAGGTCGAGAGC -> TCGGCGGTCCCAAGGTCGAGAGCA
GAGACATCGGATCCAGTCTGCTAA -> AGACATCGGATCCAGTCTGCTAAC
GCAATCATTCAGAAATCGCCGGAG -> CAATCATTCAGAAATCGCCGGAGG
AATGCATTATGGGGTACGTGACTA -> ATGCATTATGGGGTACGTGACTAC
ATGGACGGTTGCCGAGTAAGCAAT -> TGGACGGTTGCCGAGTAAGCAATC
CTCAGTCGAGGTAGTTACGATAGT -> TCAGTCGAGGTAGTTACGATAGTG
CACCTATAAGCGGAGGCCTTAGGG -> ACCTATAAGCGGAGGCCTTAGGGA
ATCATCCGGTTTAAGTTCGCACGA -> TCATCCGGTTTAAGTTCGCACGAC
AAGCCTGCCGGTACTGCACGACGT -> AGCCTGCCGGTACTGCACGACGTA
TACTCCCCGTTACCCAGGTGAGAG -> ACTCCCCGTTACCCAGGTGAGAGC
CGGTGGTCCGGATTACATGGGTTC -> GGTGGTCCGGATTACATGGGTTCG
ATCATACGATTCGCCGTGCCTATA -> TCATACGATTCGCCGTGCCTATAC
TTTGAACTCTCGGGGAGAATTGTA -> TTGAACTCTCGGGGAGAATTGTAA
CGTACGATGCTACAATCTGCGCCC -> GTACGATGCTACAATCTGCGCCCG
CCGGCCATCACTATTGCCGCTGGA -> CGGCCATCACTATTGCCGCTGGAG
TTAGGGAATTGAGTTTGTGGCGCG -> TAGGGAATTGAGTTTGTGGCGCGT
GTAACATTGAACCACGCTTGTGCT -> TAACATTGAACCACGCTTGTGCTA
GGCCAACGTAAAACTCCCCCTGCT -> GCCAACGTAAAACTCCCCCTGCTT
GACGGTTGCCGAGTAAGCAATCAT -> ACGGTTGCCGAGTAAGCAATCATT
CCTACACTAGTCCAGAGTAGGTTC -> CTACACTAGTCCAGAGTAGGTTCA
ACACCTGGCACGCCAGACACAAGA -> CACCTGGCACGCCAGACACAAGAT
CCGGGCCAAATGAATATACACGCT -> CGGGCCAAATGAATATACACGCTA
CAGATCATACGATTCGCCGTGCCT -> AGATCATACGATTCGCCGTGCCTA
GGCGTACAAAACTCTCAGTTAAAC -> GCGTACAAAACTCTCAGTTAAACG
GGATGCTAGAGAGAAAGTCACACT -> GATGCTAGAGAGAAAGTCACACTG
GAGGCCTTAGGGAATTGAGTTTGT -> AGGCCTTAGGGAATTGAGTTTGTG
TGGGAGATCCATCACTTCTACATG -> GGGAGATCCATCACTTCTACATGC
AATCATGGCTGAGAAGGACACTAG -> ATCATGGCTGAGAAGGACACTAGA
CCGCCGCGGGCAGAGACATCGGAT -> CGCCGCGGGCAGAGACATCGGATC
GTCACCTGGCCCGGGTGTCTGGCA -> TCACCTGGCCCGGGTGTCTGGCAG
CCCGACGCACCTTAGGCCCCGTAG -> CCGACGCACCTTAGGCCCCGTAGG
GGTGAGGGAAAGCTCCACTGAGCG -> GTGAGGGAAAGCTCCACTGAGCGC
CCACGGGTGGCTACCGTCAATGAG -> CACGGGTGGCTACCGTCAATGAGT
CGTAAACCGATGTGGCCAAGGTAC -> GTAAACCGATGTGGCCAAGGTACA
GCCAAGCTGCGAGCCACTCCTCTA -> CCAAGCTGCGAGCCACTCCTCTAC
GAAAATTAGGAAAAATACGACTTG -> AAAATTAGGAAAAATACGACTTGT
CATGCCTATTTCGCGTATCCTTAA -> ATGCCTATTTCGCGTATCCTTAAG
TCACACTGACCCGTACGTGGTATC -> CACACTGACCCGTACGTGGTATCT
ATCGGATCCAGTCTGCTAACTACG -> TCGGATCCAGTCTGCTAACTACGG
TACCGTCAATGAGTTGTGAGGTAC -> ACCGTCAATGAGTTGTGAGGTACA
TACCATCCCATCAGATCGTCCCAC -> ACCATCCCATCAGATCGTCCCACG
TTTAACTACTCCCCGTTACCCAGG -> TTAACTACTCCCCGTTACCCAGGT
GGGCCAAATGAATATACACGCTAC -> GGCCAAATGAATATACACGCTACA
GTATCTCATTGCGCTCTGCGATCA -> TATCTCATTGCGCTCTGCGATCAT
CTACACTAGTCCAGAGTAGGTTCA -> TACACTAGTCCAGAGTAGGTTCAG
TAGCCTACAAGTCATCTCCTCCGG -> AGCCTACAAGTCATCTCCTCCGGT
CCTGCAGACGCTTCTAGTAAACGT -> CTGCAGACGCTTCTAGTAAACGTA
TCTCCTCCGGTGTCATACCGTGAT -> CTCCTCCGGTGTCATACCGTGATT
TGAGAAGGACACTAGACGATGGAC -> GAGAAGGACACTAGACGATGGACG
CATGGTCTACAAACTTTCCGTATT -> ATGGTCTACAAACTTTCCGTATTC
ACGTACCACGGATAGGCTCCCGGA -> CGTACCACGGATAGGCTCCCGGAT
CGATGGACGGTTGCCGAGTAAGCA -> GATGGACGGTTGCCGAGTAAGCAA
TGATTTGATACAGCAGCGCCCGAC -> GATTTGATACAGCAGCGCCCGACG
GTCCCACGGGTGGCTACCGTCAAT -> TCCCACGGGTGGCTACCGTCAATG
CTACGGTCCCGTATAATCAAAGGT -> TACGGTCCCGTATAATCAAAGGTC
AAGGTAATTACGACGTCAAAACGT -> AGGTAATTACGACGTCAAAACGTA
CCGCTGGAGAGGATAATCACCTGC -> CGCTGGAGAGGATAATCACCTGCC
ACACGTATCTCCGCCGCGGGCAGA -> CACGTATCTCCGCCGCGGGCAGAG
TAGCCGTCGAGCCAAGCTGCGAGC -> AGCCGTCGAGCCAAGCTGCGAGCC
CAGCCCGCCCTCAATGATCTGCCA -> AGCCCGCCCTCAATGATCTGCCAT
CTTTCCGTATTCCATCAGCGAGCG -> TTTCCGTATTCCATCAGCGAGCGT
AACAGGTCGTATCCCCAACACGTG -> ACAGGTCGTATCCCCAACACGTGG
TCAGCGAGCGTGCGAACAAGGCCC -> CAGCGAGCGTGCGAACAAGGCCCA
AAAGCCTACACTAGTCCAGAGTAG -> AAGCCTACACTAGTCCAGAGTAGG
ACGTAACTAGCTGGTTTGTACTAA -> CGTAACTAGCTGGTTTGTACTAAT
CGGGGAGAATTGTAACTCTACGGT -> GGGGAGAATTGTAACTCTACGGTC
CCCAACACGTGGAAATCGACTTTC -> CCAACACGTGGAAATCGACTTTCG
CAAAACGTACCACGGATAGGCTCC -> AAAACGTACCACGGATAGGCTCCC
TTCGCTTCAGATCATACGATTCGC -> TCGCTTCAGATCATACGATTCGCC
TCCACTGAGCGCTCTAGCGCAGTG -> CCACTGAGCGCTCTAGCGCAGTGA
CACGTAGTCAACATGGTCTACAAA -> ACGTAGTCAACATGGTCTACAAAC
ATGAATATACACGCTACAGGACAT -> TGAATATACACGCTACAGGACATC
CACTGAGCGCTCTAGCGCAGTGAT -> ACTGAGCGCTCTAGCGCAGTGATA
AGCCTACACTAGTCCAGAGTAGGT -> GCCTACACTAGTCCAGAGTAGGTT
TTCCATCAGCGAGCGTGCGAACAA -> TCCATCAGCGAGCGTGCGAACAAG
GCGTCTGAGAGTTGTTAGTATCTG -> CGTCTGAGAGTTGTTAGTATCTGT
AGAGTTGTTAGTATCTGTTTGCCG -> GAGTTGTTAGTATCTGTTTGCCGA
ACGACTTGTGCTATAGTAACACCT -> CGACTTGTGCTATAGTAACACCTG
AGACGCTTCTAGTAAACGTACTGT -> GACGCTTCTAGTAAACGTACTGTG
GTAAATCTCAGTCGAGGTAGTTAC -> TAAATCTCAGTCGAGGTAGTTACG
CCACCCCCATTGCGTTGTATCTTG -> CACCCCCATTGCGTTGTATCTTGA
CTTGTGCTATAGTAACACCTGGCA -> TTGTGCTATAGTAACACCTGGCAC
GAACCAATGGCCTCACGCCAAGCC -> AACCAATGGCCTCACGCCAAGCCC
TTTGATACAGCAGCGCCCGACGCA -> TTGATACAGCAGCGCCCGACGCAC
AGATCCATCACTTCTACATGCCTA -> GATCCATCACTTCTACATGCCTAT
TTCCGACTTCGCTAGACTTACGTA -> TCCGACTTCGCTAGACTTACGTAA
GTCACACTGACCCGTACGTGGTAT -> TCACACTGACCCGTACGTGGTATC
AGCTGCTTATTGGGTGCAAGCACC -> GCTGCTTATTGGGTGCAAGCACCT
TGCTAACTACGGTGCTATCCCCCT -> GCTAACTACGGTGCTATCCCCCTA
TTTAACACGTAGTCAACATGGTCT -> TTAACACGTAGTCAACATGGTCTA
AAACTTTCCGTATTCCATCAGCGA -> AACTTTCCGTATTCCATCAGCGAG
TCTCAGTTAAACGGCTTCGCAGAA -> CTCAGTTAAACGGCTTCGCAGAAC
CCGCCCTCAATGATCTGCCATCTG -> CGCCCTCAATGATCTGCCATCTGG
CATGACCTGCTATTTGAACTCTCG -> ATGACCTGCTATTTGAACTCTCGG
GTAGGGAACGCGATTCGTTTTTAA -> TAGGGAACGCGATTCGTTTTTAAC
TAGTGGCCGTAAGTAACCGTCGCA -> AGTGGCCGTAAGTAACCGTCGCAG
CCCACGGGTGGCTACCGTCAATGA -> CCACGGGTGGCTACCGTCAATGAG
CTGCTTCGCTTCAGATCATACGAT -> TGCTTCGCTTCAGATCATACGATT
TAAGTAACATTGAACCACGCTTGT -> AAGTAACATTGAACCACGCTTGTG
CAAGGCGTGGGAGATCCATCACTT -> AAGGCGTGGGAGATCCATCACTTC
CGCCCTCAATGATCTGCCATCTGG -> GCCCTCAATGATCTGCCATCTGGG
TGGCAGATTACTCTACCCCGGGCC -> GGCAGATTACTCTACCCCGGGCCA
AAACTATGAATTGTACTAGCCTAC -> AACTATGAATTGTACTAGCCTACA
CCGTGATTTGATACAGCAGCGCCC -> CGTGATTTGATACAGCAGCGCCCG
CTTAGCTGCTTATTGGGTGCAAGC -> TTAGCTGCTTATTGGGTGCAAGCA
TCCGCCGCGGGCAGAGACATCGGA -> CCGCCGCGGGCAGAGACATCGGAT
AGGGAATTGAGTTTGTGGCGCGTA -> GGGAATTGAGTTTGTGGCGCGTAG
ACATAGCCCCCTCCTTCCCGTGGT -> CATAGCCCCCTCCTTCCCGTGGTT
GATCATCCGGTTTAAGTTCGCACG -> ATCATCCGGTTTAAGTTCGCACGA
GTACCCAAGCCTAGTGCAAAGAGA -> TACCCAAGCCTAGTGCAAAGAGAA
TAACTACTCCCCGTTACCCAGGTG -> AACTACTCCCCGTTACCCAGGTGA
AGGTCGAGAGCAATAACAGCATTT -> GGTCGAGAGCAATAACAGCATTTG
AGGAACCCCTATCGTAAATCTCAG -> GGAACCCCTATCGTAAATCTCAGT
GTAGTAGTAGGTATAACTTAACGA -> TAGTAGTAGGTATAACTTAACGAC
TCAATGATCTGCCATCTGGGCATT -> CAATGATCTGCCATCTGGGCATTA
TGAGCGCTCTAGCGCAGTGATAAC -> GAGCGCTCTAGCGCAGTGATAACT
TGAGAGCATAGTGAACATATCGTA -> GAGAGCATAGTGAACATATCGTAC
TATTTTTTGCTCTAGGAGCATCTG -> ATTTTTTGCTCTAGGAGCATCTGA
AATCTGCGCCCGGAGGCATAACTT -> ATCTGCGCCCGGAGGCATAACTTA
TCCGGTTTAAGTTCGCACGACAGG -> CCGGTTTAAGTTCGCACGACAGGG
GATCATACGATTCGCCGTGCCTAT -> ATCATACGATTCGCCGTGCCTATA
GTAAACGTACTGTGCGACCGTAAA -> TAAACGTACTGTGCGACCGTAAAC
AACATATCGTACGATGCTACAATC -> ACATATCGTACGATGCTACAATCT
CTTCAGATCATACGATTCGCCGTG -> TTCAGATCATACGATTCGCCGTGC
AGTAGTAGGTATAACTTAACGACT -> GTAGTAGGTATAACTTAACGACTT
TACACACGTATCTCCGCCGCGGGC -> ACACACGTATCTCCGCCGCGGGCA
GGATAGGCTCCCGGATTGGCAAAA -> GATAGGCTCCCGGATTGGCAAAAC
ATGCATTATGGGGTACGTGACTAC -> TGCATTATGGGGTACGTGACTACG
CCTCCGGTGTCATACCGTGATTTG -> CTCCGGTGTCATACCGTGATTTGA
ACCCAGGTGAGAGCATAGTGAACA -> CCCAGGTGAGAGCATAGTGAACAT
TTTTAACACGTAGTCAACATGGTC -> TTTAACACGTAGTCAACATGGTCT
TCGTAAATCTCAGTCGAGGTAGTT -> CGTAAATCTCAGTCGAGGTAGTTA
TCTATTATTTTTTGCTCTAGGAGC -> CTATTATTTTTTGCTCTAGGAGCA
TTGGACCTGCCCCCTACCGGCCAT -> TGGACCTGCCCCCTACCGGCCATC
TGGCCGTAAGTAACCGTCGCAGGA -> GGCCGTAAGTAACCGTCGCAGGAA
CGCTCTGCGATCATCCGGTTTAAG -> GCTCTGCGATCATCCGGTTTAAGT
TAGTTACGATAGTGGCCGTAAGTA -> AGTTACGATAGTGGCCGTAAGTAA
TATTTGCCTGCCCGGAATGCAATA -> ATTTGCCTGCCCGGAATGCAATAC
CGGGTGGCTACCGTCAATGAGTTG -> GGGTGGCTACCGTCAATGAGTTGT
CCCTTAAGGCATAGCCGTCGAGCC -> CCTTAAGGCATAGCCGTCGAGCCA
GCTGCTTATTGGGTGCAAGCACCT -> CTGCTTATTGGGTGCAAGCACCTA
TTCCCGTGGTTGCTCCCGTCTCCA -> TCCCGTGGTTGCTCCCGTCTCCAA
GAGTTTGTGGCGCGTAGTAGTAGG -> AGTTTGTGGCGCGTAGTAGTAGGT
GGCCCGGGTGTCTGGCAGATTACT -> GCCCGGGTGTCTGGCAGATTACTC
AACTAGCTGGTTTGTACTAATTCG -> ACTAGCTGGTTTGTACTAATTCGG
TTGAACCAAAACTGTTATTTGCCT -> TGAACCAAAACTGTTATTTGCCTG
GGTACTGCACGACGTAGGGAACGC -> GTACTGCACGACGTAGGGAACGCG
CGCACGACAGGGAACTTCAGTCCG -> GCACGACAGGGAACTTCAGTCCGG
CTTAAGTAACATTGAACCACGCTT -> TTAAGTAACATTGAACCACGCTTG
GCTTGTGCTAACTGCACGGTGAGG -> CTTGTGCTAACTGCACGGTGAGGG
ACATCGGATCCAGTCTGCTAACTA -> CATCGGATCCAGTCTGCTAACTAC
GGGTTTGGGGTGGAATTAGGTTAT -> GGTTTGGGGTGGAATTAGGTTATC
TTCGAAAGTATTGGACCTGCCCCC -> TCGAAAGTATTGGACCTGCCCCCT
ACGCGTCGCAGCTCAGTCGCCGGG -> CGCGTCGCAGCTCAGTCGCCGGGT
GAGGCATAACTTAGTATTCCGACT -> AGGCATAACTTAGTATTCCGACTT
CGTCCCACGGGTGGCTACCGTCAA -> GTCCCACGGGTGGCTACCGTCAAT
CGCAGCTCAGTCGCCGGGTAGGCA -> GCAGCTCAGTCGCCGGGTAGGCAT
ACGGGTGGCTACCGTCAATGAGTT -> CGGGTGGCTACCGTCAATGAGTTG
TGCACGGTGAGGGAAAGCTCCACT -> GCACGGTGAGGGAAAGCTCCACTG
TGGACCTGCCCCCTACCGGCCATC -> GGACCTGCCCCCTACCGGCCATCA
TGCAGGGGGCCTAAGCCTGCCGGT -> GCAGGGGGCCTAAGCCTGCCGGTA
CATCTGACGTTATAGTTCGAAAGT -> ATCTGACGTTATAGTTCGAAAGTA
TAAACCTGTCACCTGGCCCGGGTG -> AAACCTGTCACCTGGCCCGGGTGT
CGACAGGGAACTTCAGTCCGGGAG -> GACAGGGAACTTCAGTCCGGGAGT
ACAAGGCCCAATGGTCCAACAGCC -> CAAGGCCCAATGGTCCAACAGCCC
AAAGCTCCACTGAGCGCTCTAGCG -> AAGCTCCACTGAGCGCTCTAGCGC
ATGCAATACGCGTCGCAGCTCAGT -> TGCAATACGCGTCGCAGCTCAGTC
TGGTCTACAAACTTTCCGTATTCC -> GGTCTACAAACTTTCCGTATTCCA
CCTAACGTAATCATGGCTGAGAAG -> CTAACGTAATCATGGCTGAGAAGG
GGGTGGAATTAGGTTATCCAGATC -> GGTGGAATTAGGTTATCCAGATCT
AGGCATAACTTAGTATTCCGACTT -> GGCATAACTTAGTATTCCGACTTC
TATAAGCGGAGGCCTTAGGGAATT -> ATAAGCGGAGGCCTTAGGGAATTG
GAGAATTGTAACTCTACGGTCCCG -> AGAATTGTAACTCTACGGTCCCGT
ATCTACGGTGGTCCGGATTACATG -> TCTACGGTGGTCCGGATTACATGG
TACGGTGGTCCGGATTACATGGGT -> ACGGTGGTCCGGATTACATGGGTT
ACATATCGTACGATGCTACAATCT -> CATATCGTACGATGCTACAATCTG
ATACGACTTGTGCTATAGTAACAC -> TACGACTTGTGCTATAGTAACACC
TACTCTACCCCGGGCCAAATGAAT -> ACTCTACCCCGGGCCAAATGAATA
GTAAGTAACCGTCGCAGGAATAGA -> TAAGTAACCGTCGCAGGAATAGAA
GCAAAGAGAACCAATGGCCTCACG -> CAAAGAGAACCAATGGCCTCACGC
AGAGAGAAAGTCACACTGACCCGT -> GAGAGAAAGTCACACTGACCCGTA
TTCAGAGCAGTACCCAAGCCTAGT -> TCAGAGCAGTACCCAAGCCTAGTG
GCCTACAAGTCATCTCCTCCGGTG -> CCTACAAGTCATCTCCTCCGGTGT
TAACTAGCTGGTTTGTACTAATTC -> AACTAGCTGGTTTGTACTAATTCG
AGTAGGTATAACTTAACGACTTGA -> GTAGGTATAACTTAACGACTTGAA
AGAACCGGGGCGACCCTGAATGCA -> GAACCGGGGCGACCCTGAATGCAT
GATGCTAGAGAGAAAGTCACACTG -> ATGCTAGAGAGAAAGTCACACTGA
GAATATACACGCTACAGGACATCT -> AATATACACGCTACAGGACATCTA
CTACCCCGGGCCAAATGAATATAC -> TACCCCGGGCCAAATGAATATACA
TTCCGCGCGAATCGGGTCAGGTCA -> TCCGCGCGAATCGGGTCAGGTCAC
CGCTTGTGCTAACTGCACGGTGAG -> GCTTGTGCTAACTGCACGGTGAGG
GGAGGCATAACTTAGTATTCCGAC -> GAGGCATAACTTAGTATTCCGACT
CTCCGGTGTCATACCGTGATTTGA -> TCCGGTGTCATACCGTGATTTGAT
GGGTACGTGACTACGTGGGCTACG -> GGTACGTGACTACGTGGGCTACGG
CTTAACGACTTGAACGCGCATTGC -> TTAACGACTTGAACGCGCATTGCT
AACTTAACGACTTGAACGCGCATT -> ACTTAACGACTTGAACGCGCATTG
GGGTTCGGTTTAACTACTCCCCGT -> GGTTCGGTTTAACTACTCCCCGTT
AGTTGTTAGTATCTGTTTGCCGAG -> GTTGTTAGTATCTGTTTGCCGAGG
AACTCCCCCTGCTTCGCTTCAGAT -> ACTCCCCCTGCTTCGCTTCAGATC
TGGGGTACGTGACTACGTGGGCTA -> GGGGTACGTGACTACGTGGGCTAC
AGTACCCAAGCCTAGTGCAAAGAG -> GTACCCAAGCCTAGTGCAAAGAGA
AATAACAGCATTTGTCGGGGAACC -> ATAACAGCATTTGTCGGGGAACCC
GTACGTGACTACGTGGGCTACGGC -> TACGTGACTACGTGGGCTACGGCC
AAACTCCCCCTGCTTCGCTTCAGA -> AACTCCCCCTGCTTCGCTTCAGAT
TAGCTGCTTATTGGGTGCAAGCAC -> AGCTGCTTATTGGGTGCAAGCACC
AGCCTGCCGGTACTGCACGACGTA -> GCCTGCCGGTACTGCACGACGTAG
CCATCAGCGAGCGTGCGAACAAGG -> CATCAGCGAGCGTGCGAACAAGGC
GGTTTGTACTAATTCGGCTACTAA -> GTTTGTACTAATTCGGCTACTAAA
GGAATTAGGTTATCCAGATCTACC -> GAATTAGGTTATCCAGATCTACCC
TCCCTCATCGGTTGCGTAAACCGA -> CCCTCATCGGTTGCGTAAACCGAT
GCTCTAGGAGCATCTGACGTTATA -> CTCTAGGAGCATCTGACGTTATAG
ACTGCCGGTCATGACCTGCTATTT -> CTGCCGGTCATGACCTGCTATTTG
AGCCCGCCCTCAATGATCTGCCAT -> GCCCGCCCTCAATGATCTGCCATC
GCGTGGGAGATCCATCACTTCTAC -> CGTGGGAGATCCATCACTTCTACA
AGTTAAGAGCTCCTGCAGACGCTT -> GTTAAGAGCTCCTGCAGACGCTTC
TCAGGTCACGAGCTCCCATCTGGC -> CAGGTCACGAGCTCCCATCTGGCT
TGAGAGTTGTTAGTATCTGTTTGC -> GAGAGTTGTTAGTATCTGTTTGCC
CCTTAGGCCCCGTAGGCGTACAAA -> CTTAGGCCCCGTAGGCGTACAAAA
TGCTATAGTAACACCTGGCACGCC -> GCTATAGTAACACCTGGCACGCCA
GATCCATCACTTCTACATGCCTAT -> ATCCATCACTTCTACATGCCTATT
TGAATTGTACTAGCCTACAAGTCA -> GAATTGTACTAGCCTACAAGTCAT
ACGCTCCCTTAAGGCATAGCCGTC -> CGCTCCCTTAAGGCATAGCCGTCG
TCATTCAGAAATCGCCGGAGGCGT -> CATTCAGAAATCGCCGGAGGCGTC
CCCGGATTGGCAAAACTGCCGGTC -> CCGGATTGGCAAAACTGCCGGTCA
GTTAAGAGCTCCTGCAGACGCTTC -> TTAAGAGCTCCTGCAGACGCTTCT
GATCTGCCATCTGGGCATTAAGCA -> ATCTGCCATCTGGGCATTAAGCAG
CCCAATGGTCCAACAGCCCGCCCT -> CCAATGGTCCAACAGCCCGCCCTC
TATTCCATCAGCGAGCGTGCGAAC -> ATTCCATCAGCGAGCGTGCGAACA
ATGGCTGAGAAGGACACTAGACGA -> TGGCTGAGAAGGACACTAGACGAT
CTATACCATCCCATCAGATCGTCC -> TATACCATCCCATCAGATCGTCCC
AAAACTCCCCCTGCTTCGCTTCAG -> AAACTCCCCCTGCTTCGCTTCAGA
TAAGGCATAGCCGTCGAGCCAAGC -> AAGGCATAGCCGTCGAGCCAAGCT
CTCTAGGAGCATCTGACGTTATAG -> TCTAGGAGCATCTGACGTTATAGT
AAAATACGACTTGTGCTATAGTAA -> AAATACGACTTGTGCTATAGTAAC
CTTGCTGAATTAACAGGTCGTATC -> TTGCTGAATTAACAGGTCGTATCC
TATAGGGCCCATATAATTCTCGAC -> ATAGGGCCCATATAATTCTCGACT
TACATGGGTTCGGTTTAACTACTC -> ACATGGGTTCGGTTTAACTACTCC
AGACATCGGATCCAGTCTGCTAAC -> GACATCGGATCCAGTCTGCTAACT
AATTGACGCTCCCTTAAGGCATAG -> ATTGACGCTCCCTTAAGGCATAGC
GTAACCGTCGCAGGAATAGAAATG -> TAACCGTCGCAGGAATAGAAATGG
CCTGGCACGCCAGACACAAGATAG -> CTGGCACGCCAGACACAAGATAGA
TGGCACGCCAGACACAAGATAGAG -> GGCACGCCAGACACAAGATAGAGT
CCGAGTAAGCAATCATTCAGAAAT -> CGAGTAAGCAATCATTCAGAAATC
AACCTGTCACCTGGCCCGGGTGTC -> ACCTGTCACCTGGCCCGGGTGTCT
CTTAAGGCATAGCCGTCGAGCCAA -> TTAAGGCATAGCCGTCGAGCCAAG
CCTGTCACCTGGCCCGGGTGTCTG -> CTGTCACCTGGCCCGGGTGTCTGG
CACGGATAGGCTCCCGGATTGGCA -> ACGGATAGGCTCCCGGATTGGCAA
TAGCCACCCCCATTGCGTTGTATC -> AGCCACCCCCATTGCGTTGTATCT
CAATGGCCTCACGCCAAGCCCTTA -> AATGGCCTCACGCCAAGCCCTTAG
TCGGTTGCGTAAACCGATGTGGCC -> CGGTTGCGTAAACCGATGTGGCCA
TTCTAGTAAACGTACTGTGCGACC -> TCTAGTAAACGTACTGTGCGACCG
ACTTCGCTAGACTTACGTAACTAG -> CTTCGCTAGACTTACGTAACTAGC
GGCTACTAAAGACTTGCTGAATTA -> GCTACTAAAGACTTGCTGAATTAA
TTTGCTCTAGGAGCATCTGACGTT -> TTGCTCTAGGAGCATCTGACGTTA
TGCGCCCGGAGGCATAACTTAGTA -> GCGCCCGGAGGCATAACTTAGTAT
ACCTATAAGCGGAGGCCTTAGGGA -> CCTATAAGCGGAGGCCTTAGGGAA
CTTATTGGGTGCAAGCACCTATAA -> TTATTGGGTGCAAGCACCTATAAG
ATAACTTAGTATTCCGACTTCGCT -> TAACTTAGTATTCCGACTTCGCTA
ATTACTCTACCCCGGGCCAAATGA -> TTACTCTACCCCGGGCCAAATGAA
CTGAGAGTTGTTAGTATCTGTTTG -> TGAGAGTTGTTAGTATCTGTTTGC
TAAGTAACCGTCGCAGGAATAGAA -> AAGTAACCGTCGCAGGAATAGAAA
GCCGAGGTAGAGAAATTCTCGCCC -> CCGAGGTAGAGAAATTCTCGCCCA
CTGCGATCATCCGGTTTAAGTTCG -> TGCGATCATCCGGTTTAAGTTCGC
GCCTAGTGCAAAGAGAACCAATGG -> CCTAGTGCAAAGAGAACCAATGGC
GCCTGCCGGTACTGCACGACGTAG -> CCTGCCGGTACTGCACGACGTAGG
CGAGAGCAATAACAGCATTTGTCG -> GAGAGCAATAACAGCATTTGTCGG
CATTTGTCGGGGAACCCTTCTGGT -> ATTTGTCGGGGAACCCTTCTGGTG
TAATCACCTGCCGATCGAAAGGCC -> AATCACCTGCCGATCGAAAGGCCT
TCCGACTTCGCTAGACTTACGTAA -> CCGACTTCGCTAGACTTACGTAAC
GCACGACAGGGAACTTCAGTCCGG -> CACGACAGGGAACTTCAGTCCGGG
TTTGTCGGGGAACCCTTCTGGTGA -> TTGTCGGGGAACCCTTCTGGTGAT
CTTGAACGCGCATTGCTTCCGCGC -> TTGAACGCGCATTGCTTCCGCGCG
GTGGTTGCTCCCGTCTCCAAGGCG -> TGGTTGCTCCCGTCTCCAAGGCGT
TTAAGGCATAGCCGTCGAGCCAAG -> TAAGGCATAGCCGTCGAGCCAAGC
CTCTCGGGGAGAATTGTAACTCTA -> TCTCGGGGAGAATTGTAACTCTAC
TACTAATTCGGCTACTAAAGACTT -> ACTAATTCGGCTACTAAAGACTTG
ATAGCCGTCGAGCCAAGCTGCGAG -> TAGCCGTCGAGCCAAGCTGCGAGC
GTTAGTATCTGTTTGCCGAGGTAG -> TTAGTATCTGTTTGCCGAGGTAGA
GATTCGCCGTGCCTATACCATCCC -> ATTCGCCGTGCCTATACCATCCCA
ATTAAGCAGTGAAATATCCGCATC -> TTAAGCAGTGAAATATCCGCATCG
TCAGTTAAACGGCTTCGCAGAACC -> CAGTTAAACGGCTTCGCAGAACCG
CTATTTGAACTCTCGGGGAGAATT -> TATTTGAACTCTCGGGGAGAATTG
GACTTCGCTAGACTTACGTAACTA -> ACTTCGCTAGACTTACGTAACTAG
GATTCGTTTTTAACACGTAGTCAA -> ATTCGTTTTTAACACGTAGTCAAC
GCGTGCGAACAAGGCCCAATGGTC -> CGTGCGAACAAGGCCCAATGGTCC
CTCGACTTAGCTGCTTATTGGGTG -> TCGACTTAGCTGCTTATTGGGTGC
CTGCCCGGAATGCAATACGCGTCG -> TGCCCGGAATGCAATACGCGTCGC
GCGTAAACCGATGTGGCCAAGGTA -> CGTAAACCGATGTGGCCAAGGTAC
GATTACATGGGTTCGGTTTAACTA -> ATTACATGGGTTCGGTTTAACTAC
TGAACCAAAACTGTTATTTGCCTG -> GAACCAAAACTGTTATTTGCCTGC
ACAAGTCATCTCCTCCGGTGTCAT -> CAAGTCATCTCCTCCGGTGTCATA
TCTGCGCCCGGAGGCATAACTTAG -> CTGCGCCCGGAGGCATAACTTAGT
TTCGGCTACTAAAGACTTGCTGAA -> TCGGCTACTAAAGACTTGCTGAAT
GAACCCCTATCGTAAATCTCAGTC -> AACCCCTATCGTAAATCTCAGTCG
TGCCTGCCCGGAATGCAATACGCG -> GCCTGCCCGGAATGCAATACGCGT
CTATTTCGCGTATCCTTAAGGTAA -> TATTTCGCGTATCCTTAAGGTAAT
ATTAGGTTATCCAGATCTACCCAG -> TTAGGTTATCCAGATCTACCCAGT
TACATGCCTATTTCGCGTATCCTT -> ACATGCCTATTTCGCGTATCCTTA
CTTCTACATGCCTATTTCGCGTAT -> TTCTACATGCCTATTTCGCGTATC
GCGTCGCAGCTCAGTCGCCGGGTA -> CGTCGCAGCTCAGTCGCCGGGTAG
ATGGGTCTATTATTTTTTGCTCTA -> TGGGTCTATTATTTTTTGCTCTAG
CCATCAGATCGTCCCACGGGTGGC -> CATCAGATCGTCCCACGGGTGGCT
GCAGGAATAGAAATGGGTCTATTA -> CAGGAATAGAAATGGGTCTATTAT
TGGGTTTGGGGTGGAATTAGGTTA -> GGGTTTGGGGTGGAATTAGGTTAT
TATTTGAACTCTCGGGGAGAATTG -> ATTTGAACTCTCGGGGAGAATTGT
TTTTTTGCTCTAGGAGCATCTGAC -> TTTTTGCTCTAGGAGCATCTGACG
CAGAGACATCGGATCCAGTCTGCT -> AGAGACATCGGATCCAGTCTGCTA
AGAAATCGCCGGAGGCGTCTGAGA -> GAAATCGCCGGAGGCGTCTGAGAG
AGAGTAGGTTCAGAGCAGTACCCA -> GAGTAGGTTCAGAGCAGTACCCAA
GCCGGTACTGCACGACGTAGGGAA -> CCGGTACTGCACGACGTAGGGAAC
CCGGTCATGACCTGCTATTTGAAC -> CGGTCATGACCTGCTATTTGAACT
TTAGGAAAAATACGACTTGTGCTA -> TAGGAAAAATACGACTTGTGCTAT
GAAAGCTCCACTGAGCGCTCTAGC -> AAAGCTCCACTGAGCGCTCTAGCG
TGCCTATTTCGCGTATCCTTAAGG -> GCCTATTTCGCGTATCCTTAAGGT
TAGACTTACGTAACTAGCTGGTTT -> AGACTTACGTAACTAGCTGGTTTG
ATTCCGACTTCGCTAGACTTACGT -> TTCCGACTTCGCTAGACTTACGTA
ACATCTACGGTGGTCCGGATTACA -> CATCTACGGTGGTCCGGATTACAT
TGTTTGCCGAGGTAGAGAAATTCT -> GTTTGCCGAGGTAGAGAAATTCTC
AAAGTATTGGACCTGCCCCCTACC -> AAGTATTGGACCTGCCCCCTACCG
GAACGCGATTCGTTTTTAACACGT -> AACGCGATTCGTTTTTAACACGTA
CCCAGTTAAGAGCTCCTGCAGACG -> CCAGTTAAGAGCTCCTGCAGACGC
CCTTAAGGCATAGCCGTCGAGCCA -> CTTAAGGCATAGCCGTCGAGCCAA
GGTTATCCAGATCTACCCAGTTAA -> GTTATCCAGATCTACCCAGTTAAG
TTACATGGGTTCGGTTTAACTACT -> TACATGGGTTCGGTTTAACTACTC
CAATGGTCCAACAGCCCGCCCTCA -> AATGGTCCAACAGCCCGCCCTCAA
GTGCTATAGTAACACCTGGCACGC -> TGCTATAGTAACACCTGGCACGCC
AACGTAATCATGGCTGAGAAGGAC -> ACGTAATCATGGCTGAGAAGGACA
AGAAGGACACTAGACGATGGACGG -> GAAGGACACTAGACGATGGACGGT
AGCAGTGAAATATCCGCATCGCAG -> GCAGTGAAATATCCGCATCGCAGG
AATCATTCAGAAATCGCCGGAGGC -> ATCATTCAGAAATCGCCGGAGGCG
CTTCAGTCCGGGAGTTCGCGTCAG -> TTCAGTCCGGGAGTTCGCGTCAGA
TCACCTGGCCCGGGTGTCTGGCAG -> CACCTGGCCCGGGTGTCTGGCAGA
CCGCGCGAATCGGGTCAGGTCACG -> CGCGCGAATCGGGTCAGGTCACGA
GGCATGGGTTTGGGGTGGAATTAG -> GCATGGGTTTGGGGTGGAATTAGG
GGTGCTATCCCCCTAACGTAATCA -> GTGCTATCCCCCTAACGTAATCAT
TTCTGGTGATCTTAAGTAACATTG -> TCTGGTGATCTTAAGTAACATTGA
TATAGTAACACCTGGCACGCCAGA -> ATAGTAACACCTGGCACGCCAGAC
GAGAAGGACACTAGACGATGGACG -> AGAAGGACACTAGACGATGGACGG
AACGTACTGTGCGACCGTAAACCT -> ACGTACTGTGCGACCGTAAACCTG
TATAGTTCGAAAGTATTGGACCTG -> ATAGTTCGAAAGTATTGGACCTGC
CGTAAAACTCCCCCTGCTTCGCTT -> GTAAAACTCCCCCTGCTTCGCTTC
GACGCTCCCTTAAGGCATAGCCGT -> ACGCTCCCTTAAGGCATAGCCGTC
TCTCCGCCGCGGGCAGAGACATCG -> CTCCGCCGCGGGCAGAGACATCGG
AATGAATATACACGCTACAGGACA -> ATGAATATACACGCTACAGGACAT
AGAAATGGGTCTATTATTTTTTGC -> GAAATGGGTCTATTATTTTTTGCT
GGTCCCGTATAATCAAAGGTCGGC -> GTCCCGTATAATCAAAGGTCGGCG
CCCAAGGTCGAGAGCAATAACAGC -> CCAAGGTCGAGAGCAATAACAGCA
TCGCTTCAGATCATACGATTCGCC -> CGCTTCAGATCATACGATTCGCCG
GCCATCACTATTGCCGCTGGAGAG -> CCATCACTATTGCCGCTGGAGAGG
ATGCTACAATCTGCGCCCGGAGGC -> TGCTACAATCTGCGCCCGGAGGCA
GAGTTGTGAGGTACATAGCCCCCT -> AGTTGTGAGGTACATAGCCCCCTC
AGCATAGTGAACATATCGTACGAT -> GCATAGTGAACATATCGTACGATG
TGTACTAATTCGGCTACTAAAGAC -> GTACTAATTCGGCTACTAAAGACT
CCGTATTCCATCAGCGAGCGTGCG -> CGTATTCCATCAGCGAGCGTGCGA
ACTTTCGTTGGATGCTAGAGAGAA -> CTTTCGTTGGATGCTAGAGAGAAA
CCAGAGTAGGTTCAGAGCAGTACC -> CAGAGTAGGTTCAGAGCAGTACCC
TGCCGCTGGAGAGGATAATCACCT -> GCCGCTGGAGAGGATAATCACCTG
AGAGCAATAACAGCATTTGTCGGG -> GAGCAATAACAGCATTTGTCGGGG
TGTGGCCAAGGTACACACGTATCT -> GTGGCCAAGGTACACACGTATCTC
GTTAGGTTGCGAATTGACGCTCCC -> TTAGGTTGCGAATTGACGCTCCCT
ACTGCACGACGTAGGGAACGCGAT -> CTGCACGACGTAGGGAACGCGATT
GACTTTCGTTGGATGCTAGAGAGA -> ACTTTCGTTGGATGCTAGAGAGAA
TCATATAGGGCCCATATAATTCTC -> CATATAGGGCCCATATAATTCTCG
TGGGTGCAAGCACCTATAAGCGGA -> GGGTGCAAGCACCTATAAGCGGAG
TACAGCAGCGCCCGACGCACCTTA -> ACAGCAGCGCCCGACGCACCTTAG
CTCCAAGGCGTGGGAGATCCATCA -> TCCAAGGCGTGGGAGATCCATCAC
CAGTGAAATATCCGCATCGCAGGA -> AGTGAAATATCCGCATCGCAGGAA
AGGTCGGCGGTCCCAAGGTCGAGA -> GGTCGGCGGTCCCAAGGTCGAGAG
TTGTGAGGTACATAGCCCCCTCCT -> TGTGAGGTACATAGCCCCCTCCTT
TGCAGACGCTTCTAGTAAACGTAC -> GCAGACGCTTCTAGTAAACGTACT
GTCTGCTAACTACGGTGCTATCCC -> TCTGCTAACTACGGTGCTATCCCC
TGGCCTCACGCCAAGCCCTTAGTA -> GGCCTCACGCCAAGCCCTTAGTAA
GTGGGCTACGGCCAACGTAAAACT -> TGGGCTACGGCCAACGTAAAACTC
AGCTCCACTGAGCGCTCTAGCGCA -> GCTCCACTGAGCGCTCTAGCGCAG
CAACAGCCCGCCCTCAATGATCTG -> AACAGCCCGCCCTCAATGATCTGC
ATCGTCGAAAATTAGGAAAAATAC -> TCGTCGAAAATTAGGAAAAATACG
GCATAACTTAGTATTCCGACTTCG -> CATAACTTAGTATTCCGACTTCGC
CGCCCGACGCACCTTAGGCCCCGT -> GCCCGACGCACCTTAGGCCCCGTA
TCCCGTGGTTGCTCCCGTCTCCAA -> CCCGTGGTTGCTCCCGTCTCCAAG
TAGCTGGTTTGTACTAATTCGGCT -> AGCTGGTTTGTACTAATTCGGCTA
CAGGAATAGAAATGGGTCTATTAT -> AGGAATAGAAATGGGTCTATTATT
TAGTAACACCTGGCACGCCAGACA -> AGTAACACCTGGCACGCCAGACAC
AGGTGAGAGCATAGTGAACATATC -> GGTGAGAGCATAGTGAACATATCG
CCTATCGTAAATCTCAGTCGAGGT -> CTATCGTAAATCTCAGTCGAGGTA
GCCCCCTACCGGCCATCACTATTG -> CCCCCTACCGGCCATCACTATTGC
GCACCTATAAGCGGAGGCCTTAGG -> CACCTATAAGCGGAGGCCTTAGGG
ATTATGGGGTACGTGACTACGTGG -> TTATGGGGTACGTGACTACGTGGG
CTTAGGCCCCGTAGGCGTACAAAA -> TTAGGCCCCGTAGGCGTACAAAAC
GTGATCTTAAGTAACATTGAACCA -> TGATCTTAAGTAACATTGAACCAC
GCTACCGTCAATGAGTTGTGAGGT -> CTACCGTCAATGAGTTGTGAGGTA
TGCTATTTGAACTCTCGGGGAGAA -> GCTATTTGAACTCTCGGGGAGAAT
AATGAGTTGTGAGGTACATAGCCC -> ATGAGTTGTGAGGTACATAGCCCC
AAATTCTCGCCCACTACGAAAGCC -> AATTCTCGCCCACTACGAAAGCCT
ACCTGGCCCGGGTGTCTGGCAGAT -> CCTGGCCCGGGTGTCTGGCAGATT
CGACTTCGCTAGACTTACGTAACT -> GACTTCGCTAGACTTACGTAACTA
ACCCAAGCCTAGTGCAAAGAGAAC -> CCCAAGCCTAGTGCAAAGAGAACC
TATAACTTAACGACTTGAACGCGC -> ATAACTTAACGACTTGAACGCGCA
TAACTTAGTATTCCGACTTCGCTA -> AACTTAGTATTCCGACTTCGCTAG
GGGCATTAAGCAGTGAAATATCCG -> GGCATTAAGCAGTGAAATATCCGC
CCCCATTGCGTTGTATCTTGAACC -> CCCATTGCGTTGTATCTTGAACCA
CCATCTGGCTGCAGGGGGCCTAAG -> CATCTGGCTGCAGGGGGCCTAAGC
CGGTTTAAGTTCGCACGACAGGGA -> GGTTTAAGTTCGCACGACAGGGAA
CGGATCCAGTCTGCTAACTACGGT -> GGATCCAGTCTGCTAACTACGGTG
CCAATGGTCCAACAGCCCGCCCTC -> CAATGGTCCAACAGCCCGCCCTCA
AGGCGTGGGAGATCCATCACTTCT -> GGCGTGGGAGATCCATCACTTCTA
GCCGGTCATGACCTGCTATTTGAA -> CCGGTCATGACCTGCTATTTGAAC
ATTGGCAAAACTGCCGGTCATGAC -> TTGGCAAAACTGCCGGTCATGACC
AGCACCTATAAGCGGAGGCCTTAG -> GCACCTATAAGCGGAGGCCTTAGG
GCAGGGGGCCTAAGCCTGCCGGTA -> CAGGGGGCCTAAGCCTGCCGGTAC
GACATCTACGGTGGTCCGGATTAC -> ACATCTACGGTGGTCCGGATTACA
GCCGTCGAGCCAAGCTGCGAGCCA -> CCGTCGAGCCAAGCTGCGAGCCAC
TATCCGCATCGCAGGAACCCCTAT -> ATCCGCATCGCAGGAACCCCTATC
CAGTTAAACGGCTTCGCAGAACCG -> AGTTAAACGGCTTCGCAGAACCGG
ACGTGGTATCTCATTGCGCTCTGC -> CGTGGTATCTCATTGCGCTCTGCG
AGTATCTGTTTGCCGAGGTAGAGA -> GTATCTGTTTGCCGAGGTAGAGAA
CACCCCCATTGCGTTGTATCTTGA -> ACCCCCATTGCGTTGTATCTTGAA
GAAAGGCCTCTCCCTCATCGGTTG -> AAAGGCCTCTCCCTCATCGGTTGC
GAGAAAGTCACACTGACCCGTACG -> AGAAAGTCACACTGACCCGTACGT
TCCCATCAGATCGTCCCACGGGTG -> CCCATCAGATCGTCCCACGGGTGG
GCGTATCCTTAAGGTAATTACGAC -> CGTATCCTTAAGGTAATTACGACG
TGATAACTAGCCACCCCCATTGCG -> GATAACTAGCCACCCCCATTGCGT
GCTACAGGACATCTACGGTGGTCC -> CTACAGGACATCTACGGTGGTCCG
CTCAATGATCTGCCATCTGGGCAT -> TCAATGATCTGCCATCTGGGCATT
CGTAGTAGTAGGTATAACTTAACG -> GTAGTAGTAGGTATAACTTAACGA
TACAATCTGCGCCCGGAGGCATAA -> ACAATCTGCGCCCGGAGGCATAAC
TAACACGTAGTCAACATGGTCTAC -> AACACGTAGTCAACATGGTCTACA
TGTTATTTGCCTGCCCGGAATGCA -> GTTATTTGCCTGCCCGGAATGCAA
AGCAGCGCCCGACGCACCTTAGGC -> GCAGCGCCCGACGCACCTTAGGCC
AATTCTCGACTTAGCTGCTTATTG -> ATTCTCGACTTAGCTGCTTATTGG
TACGCGTCGCAGCTCAGTCGCCGG -> ACGCGTCGCAGCTCAGTCGCCGGG
GCCACCCCCATTGCGTTGTATCTT -> CCACCCCCATTGCGTTGTATCTTG
TCTCGGGGAGAATTGTAACTCTAC -> CTCGGGGAGAATTGTAACTCTACG
ACAAAACTCTCAGTTAAACGGCTT -> CAAAACTCTCAGTTAAACGGCTTC
CTGCCGATCGAAAGGCCTCTCCCT -> TGCCGATCGAAAGGCCTCTCCCTC
ATTCGTTTTTAACACGTAGTCAAC -> TTCGTTTTTAACACGTAGTCAACA
TGGCGCGTAGTAGTAGGTATAACT -> GGCGCGTAGTAGTAGGTATAACTT
TAACCGTCGCAGGAATAGAAATGG -> AACCGTCGCAGGAATAGAAATGGG
TAAGGTAATTACGACGTCAAAACG -> AAGGTAATTACGACGTCAAAACGT
CTCCCGTCTCCAAGGCGTGGGAGA -> TCCCGTCTCCAAGGCGTGGGAGAT
TAGGTTCAGAGCAGTACCCAAGCC -> AGGTTCAGAGCAGTACCCAAGCCT
CCCGTAGGCGTACAAAACTCTCAG -> CCGTAGGCGTACAAAACTCTCAGT
CGTATCTCCGCCGCGGGCAGAGAC -> GTATCTCCGCCGCGGGCAGAGACA
CGTCTCCAAGGCGTGGGAGATCCA -> GTCTCCAAGGCGTGGGAGATCCAT
GGTCCGGATTACATGGGTTCGGTT -> GTCCGGATTACATGGGTTCGGTTT
CCCGGGCCAAATGAATATACACGC -> CCGGGCCAAATGAATATACACGCT
GGCTACCGTCAATGAGTTGTGAGG -> GCTACCGTCAATGAGTTGTGAGGT
AGTAGGTTCAGAGCAGTACCCAAG -> GTAGGTTCAGAGCAGTACCCAAGC
AAGACTTGCTGAATTAACAGGTCG -> AGACTTGCTGAATTAACAGGTCGT
CGTACAAAACTCTCAGTTAAACGG -> GTACAAAACTCTCAGTTAAACGGC
CCCGTATAATCAAAGGTCGGCGGT -> CCGTATAATCAAAGGTCGGCGGTC
GCCGGGTAGGCATGGGTTTGGGGT -> CCGGGTAGGCATGGGTTTGGGGTG
CCGTCGCAGGAATAGAAATGGGTC -> CGTCGCAGGAATAGAAATGGGTCT
AGTAAACGTACTGTGCGACCGTAA -> GTAAACGTACTGTGCGACCGTAAA
CGTCGAGCCAAGCTGCGAGCCACT -> GTCGAGCCAAGCTGCGAGCCACTC
CGCCGCGGGCAGAGACATCGGATC -> GCCGCGGGCAGAGACATCGGATCC
TCTACCCAGTTAAGAGCTCCTGCA -> CTACCCAGTTAAGAGCTCCTGCAG
CTCCGCCGCGGGCAGAGACATCGG -> TCCGCCGCGGGCAGAGACATCGGA
CCATCTGGGCATTAAGCAGTGAAA -> CATCTGGGCATTAAGCAGTGAAAT
AGCAGTACCCAAGCCTAGTGCAAA -> GCAGTACCCAAGCCTAGTGCAAAG
GGTTGCGTAAACCGATGTGGCCAA -> GTTGCGTAAACCGATGTGGCCAAG
CAGAGTAGGTTCAGAGCAGTACCC -> AGAGTAGGTTCAGAGCAGTACCCA
CGTCAAAACGTACCACGGATAGGC -> GTCAAAACGTACCACGGATAGGCT
TCGAGGTAGTTACGATAGTGGCCG -> CGAGGTAGTTACGATAGTGGCCGT
CCAGATCTACCCAGTTAAGAGCTC -> CAGATCTACCCAGTTAAGAGCTCC
TCTGAGAGTTGTTAGTATCTGTTT -> CTGAGAGTTGTTAGTATCTGTTTG
GGACACTAGACGATGGACGGTTGC -> GACACTAGACGATGGACGGTTGCC
CGAGCCAAGCTGCGAGCCACTCCT -> GAGCCAAGCTGCGAGCCACTCCTC
GGGTGGCTACCGTCAATGAGTTGT -> GGTGGCTACCGTCAATGAGTTGTG
ATGTGGCCAAGGTACACACGTATC -> TGTGGCCAAGGTACACACGTATCT
TAATTCGGCTACTAAAGACTTGCT -> AATTCGGCTACTAAAGACTTGCTG
GTGCTATCCCCCTAACGTAATCAT -> TGCTATCCCCCTAACGTAATCATG
CCTTAGGGAATTGAGTTTGTGGCG -> CTTAGGGAATTGAGTTTGTGGCGC
TACCCAGTTAAGAGCTCCTGCAGA -> ACCCAGTTAAGAGCTCCTGCAGAC
CGGGTGTCTGGCAGATTACTCTAC -> GGGTGTCTGGCAGATTACTCTACC
TGGTTGCTCCCGTCTCCAAGGCGT -> GGTTGCTCCCGTCTCCAAGGCGTG
CGCCGGGTAGGCATGGGTTTGGGG -> GCCGGGTAGGCATGGGTTTGGGGT
CGCCAGACACAAGATAGAGTTCAT -> GCCAGACACAAGATAGAGTTCATA
CCTCAATGATCTGCCATCTGGGCA -> CTCAATGATCTGCCATCTGGGCAT
ATATCGTACGATGCTACAATCTGC -> TATCGTACGATGCTACAATCTGCG
TCATCCGGTTTAAGTTCGCACGAC -> CATCCGGTTTAAGTTCGCACGACA
ACTGACCCGTACGTGGTATCTCAT -> CTGACCCGTACGTGGTATCTCATT
AGTTCGCACGACAGGGAACTTCAG -> GTTCGCACGACAGGGAACTTCAGT
GTCGGGGAACCCTTCTGGTGATCT -> TCGGGGAACCCTTCTGGTGATCTT
ATTAGGAAAAATACGACTTGTGCT -> TTAGGAAAAATACGACTTGTGCTA
CTCACGCCAAGCCCTTAGTAAAAC -> TCACGCCAAGCCCTTAGTAAAACA
GCATTAAGCAGTGAAATATCCGCA -> CATTAAGCAGTGAAATATCCGCAT
AGTCAACATGGTCTACAAACTTTC -> GTCAACATGGTCTACAAACTTTCC
CTTCGCAGAACCGGGGCGACCCTG -> TTCGCAGAACCGGGGCGACCCTGA
TCGACTTAGCTGCTTATTGGGTGC -> CGACTTAGCTGCTTATTGGGTGCA
CCCGGAATGCAATACGCGTCGCAG -> CCGGAATGCAATACGCGTCGCAGC
GTGTCATACCGTGATTTGATACAG -> TGTCATACCGTGATTTGATACAGC
AACCGATGTGGCCAAGGTACACAC -> ACCGATGTGGCCAAGGTACACACG
GCGCTCTAGCGCAGTGATAACTAG -> CGCTCTAGCGCAGTGATAACTAGC
CTGGCAGATTACTCTACCCCGGGC -> TGGCAGATTACTCTACCCCGGGCC
CCAACGTAAAACTCCCCCTGCTTC -> CAACGTAAAACTCCCCCTGCTTCG
TTGTACTAGCCTACAAGTCATCTC -> TGTACTAGCCTACAAGTCATCTCC
CAAGCCCTTAGTAAAACAAACTAT -> AAGCCCTTAGTAAAACAAACTATG
TCAATGAGTTGTGAGGTACATAGC -> CAATGAGTTGTGAGGTACATAGCC
TGGACGGTTGCCGAGTAAGCAATC -> GGACGGTTGCCGAGTAAGCAATCA
TCATGACCTGCTATTTGAACTCTC -> CATGACCTGCTATTTGAACTCTCG
CGTGGAAATCGACTTTCGTTGGAT -> GTGGAAATCGACTTTCGTTGGATG
TCTCATTGCGCTCTGCGATCATCC -> CTCATTGCGCTCTGCGATCATCCG
GAACATATCGTACGATGCTACAAT -> AACATATCGTACGATGCTACAATC
ACTGAGCGCTCTAGCGCAGTGATA -> CTGAGCGCTCTAGCGCAGTGATAA
GACACAAGATAGAGTTCATATAGG -> ACACAAGATAGAGTTCATATAGGG
AACTGCCGGTCATGACCTGCTATT -> ACTGCCGGTCATGACCTGCTATTT
TAAGCAGTGAAATATCCGCATCGC -> AAGCAGTGAAATATCCGCATCGCA
ACTATTGCCGCTGGAGAGGATAAT -> CTATTGCCGCTGGAGAGGATAATC
TTACGTAACTAGCTGGTTTGTACT -> TACGTAACTAGCTGGTTTGTACTA
GATCGTCCCACGGGTGGCTACCGT -> ATCGTCCCACGGGTGGCTACCGTC
GTTGCCGAGTAAGCAATCATTCAG -> TTGCCGAGTAAGCAATCATTCAGA
CTATAGTAACACCTGGCACGCCAG -> TATAGTAACACCTGGCACGCCAGA
AGCTCAGTCGCCGGGTAGGCATGG -> GCTCAGTCGCCGGGTAGGCATGGG
TGTCTGGCAGATTACTCTACCCCG -> GTCTGGCAGATTACTCTACCCCGG
CTACATGCCTATTTCGCGTATCCT -> TACATGCCTATTTCGCGTATCCTT
TCAAAGGTCGGCGGTCCCAAGGTC -> CAAAGGTCGGCGGTCCCAAGGTCG
CTAGCGCAGTGATAACTAGCCACC -> TAGCGCAGTGATAACTAGCCACCC
TCTACATGCCTATTTCGCGTATCC -> CTACATGCCTATTTCGCGTATCCT
TCTCGCCCACTACGAAAGCCTACA -> CTCGCCCACTACGAAAGCCTACAC
AGTAACATTGAACCACGCTTGTGC -> GTAACATTGAACCACGCTTGTGCT
AAGCACCTATAAGCGGAGGCCTTA -> AGCACCTATAAGCGGAGGCCTTAG
CTTCCGCGCGAATCGGGTCAGGTC -> TTCCGCGCGAATCGGGTCAGGTCA
CCGGAGGCGTCTGAGAGTTGTTAG -> CGGAGGCGTCTGAGAGTTGTTAGT
GGTCCAACAGCCCGCCCTCAATGA -> GTCCAACAGCCCGCCCTCAATGAT
CCTACAAGTCATCTCCTCCGGTGT -> CTACAAGTCATCTCCTCCGGTGTC
GTTGGATGCTAGAGAGAAAGTCAC -> TTGGATGCTAGAGAGAAAGTCACA
GTATCCTTAAGGTAATTACGACGT -> TATCCTTAAGGTAATTACGACGTC
GGAGTTCGCGTCAGAGGTTAGGTT -> GAGTTCGCGTCAGAGGTTAGGTTG
TCCGCATCGCAGGAACCCCTATCG -> CCGCATCGCAGGAACCCCTATCGT
CATCCGGTTTAAGTTCGCACGACA -> ATCCGGTTTAAGTTCGCACGACAG
TAACATTGAACCACGCTTGTGCTA -> AACATTGAACCACGCTTGTGCTAA
CGCAGAACCGGGGCGACCCTGAAT -> GCAGAACCGGGGCGACCCTGAATG
GTACACACGTATCTCCGCCGCGGG -> TACACACGTATCTCCGCCGCGGGC
GGCGACCCTGAATGCATTATGGGG -> GCGACCCTGAATGCATTATGGGGT
AGGCGTACAAAACTCTCAGTTAAA -> GGCGTACAAAACTCTCAGTTAAAC
AAAATTAGGAAAAATACGACTTGT -> AAATTAGGAAAAATACGACTTGTG
TAACGACTTGAACGCGCATTGCTT -> AACGACTTGAACGCGCATTGCTTC
AGCTCCTGCAGACGCTTCTAGTAA -> GCTCCTGCAGACGCTTCTAGTAAA
CGAGGTAGAGAAATTCTCGCCCAC -> GAGGTAGAGAAATTCTCGCCCACT
TCACGCCAAGCCCTTAGTAAAACA -> CACGCCAAGCCCTTAGTAAAACAA
CACGCTTGTGCTAACTGCACGGTG -> ACGCTTGTGCTAACTGCACGGTGA
TTATGGGGTACGTGACTACGTGGG -> TATGGGGTACGTGACTACGTGGGC
CGTGGGAGATCCATCACTTCTACA -> GTGGGAGATCCATCACTTCTACAT
TATTGCCGCTGGAGAGGATAATCA -> ATTGCCGCTGGAGAGGATAATCAC
AAACGTACTGTGCGACCGTAAACC -> AACGTACTGTGCGACCGTAAACCT
GAACCGGGGCGACCCTGAATGCAT -> AACCGGGGCGACCCTGAATGCATT